. سميج . ربرث						      |	. سميج . ربرت
وهو . دالبلا يف اهنوضقي يتلا ةدملا ةدايزو بناجالا نيحئاسلا دد |	وهو . دالبلا يف اهنوضقي يتلا ةدملا ةدايزو بناجالا نيحملاسلا د
ضعب يوريو يناثلاو لوالا يسلا ىلا يهتنيف هترابع ةسالسو باذجلا  |	ضعب يوريو يناثلاو لوالا يبسلا ىلا يهتنيف هتوابع ةسالسو باذجلا
زاهجلا نع هريرقت يف دراولا ركنس لوب ريسلا يأرً اضاي وه اذهو .  |	زاهجلا نع هريرقت يف دراولا ركنس لوب ريسلا يأرًاضيا وه اذهو . ل
دجن شارفلل ًامئاق ًاعطقم انذخا اذا نحنو . ةرايطلا ةحنجا هيلع ین |	دجن شارفلل ًامئاقًًاعطقم انذخا اذا نحنو . ةرايطلا ةحنجا هيلع ىنب
ةيبرتلا بولسا ،اهنم ملسملا هب ىلحتي نا بجي امو قالخالاو مالسا |	ةيبرتلا بولسا ،اهنم ملسملا دب ىلحتي نا بجي امو قالخالاو مالسا
. ةنامورلا ةريظحلا ىلا ةلتحملا				      |	. ةينامورلا ةريظحلا ىلا ةلتحملا
تاـساردلل ةيرصملا ةيعمجلا ،ةرهاقلا . ١٨٤٠ - ١٨٣٠ يرصملا مكحلا |	تاساردلل ةيرصملا ةيعمجلا ،ةرهاقلا . ١٨٤.٠ - ١٨٣٠ يرصملا مكحلا
ص ١٩٢ . ١٩٦٢ ،داشرالا ةعبطم ،دادغب . داصتقالا يف تالاقم .     |	. ص ١٩٢ . ١٩٦٢ ،داشرالا ةعبطم ،دادغب . داصتقالا يف تالاقم
- ٤٧ -							      |	-- ٤؟٧٣ هس
. مهتاموکح لبق						      |	. مهتاموکح لبقا
نم صوصنلاو بتكلا هذهل امل ثحبلا اذهل ددحملا رصعلا لالخ ترشن ي |	نم صوصنلاو بتكلا هذهل امل ثحبلا اذهل ددحملا رصعلا لالخ ترشن ي
بعشتم صصختم زاـهج ةطخلا هذه جمارب ذـيفنت ىلع فارشالا .	      |	بعشتم صصختم زاهج ةطخلا هذه جمارب ذيفنت ىلع فارشالا
ثاحبالاو تاكوكسملا ريدم يدنبشقنلا رصان موحرملا هبتک لاقم رخآ  |	ثاحبالاو تاكوكسملا ريدم يدنبشقنلا رصان موحرملا هبتك لاقم رخآ 
نع هـتمتاخو هايملاو ةعارزلا نع لصف هيفو . هلودلل ةيبنجالاو ةي |	نع همممتاخو هايملاو ةعارزلا نع لصف هيفو . هلودلل ةيبنجالاو ةي
ةمظنالاو نيناوقللً اقوف اهلبق نم اهلامعتسا نكميو ةلماكلا ةيسنر |	ةمظنالاو نيناوقلل ًاقوو اهلبق نم اهلامعتسا نکميو ةلماكلا ةيسنر
ةکرحتم روص ضرع اھولتی					      |	ةکرحتم روص ضرع اهولتي
ءزجلل هذه هتعبط يفف . ةرم لوال باتكلا عـبط هنا معز نيح ،باتكل |	هزجلل هذه هتعبط يفف . ةرم لوال باتكلا عبط هنا معز نيح ،باتكلا
. يکبلعب يزمر : هررح					      |	. يكبلعب يزمر : هروح
الا مهللا - رخآ بعش اهيلا مهقبس املق ةجرد ىلا لصو يذلا نوناقل |	الا مهلا - رخآ بعش اهيلا مهقبس املق ةجرد ىلا لصو يذلا نوناقلا
ودبيو . ًايعوضومً اخرمؤ الً اعفامد ًارشبم ةيميت نبا نع هتباتك يف  |	ودبيو . ًايعوضوً اخرم ال ً اعفادم ًارشبم ةيميت نبا نع هتباتك يف ن
: يمالسإلا يـبرعلا ركفلا يف بسكلاو لمعلا نع نراقو . ٤٧ ص ،بسك |	: يمالسإلا يبرعلا ركفلا يف بسكلاو لمعلا نع نراقو . ٤٧ ص ،بسكل
ةماقاب حمس دق ةدحتملا ممالا ةمظنم يفً اوعض ةيدوعسلا ةيبرعلا ةك |	ةماقاب حمس دق ةدحتملا ممالا ةمظنم يفً اوض ةيدوعسلا ةيبرعلا ةكل
. مهتاموكحل مهلخد نم دیازتم مسق				      |	. مهتاموکحل مهلخد نم ديازتم مسق
ةيبرعلا لودلاو نانويلا يف تمقافت نا تثبل ام نيدرـشملا نيئجالل |	ةيبرعلا لودلاو نانويلا يف تمافت نا تشبل ام نيدرشملا نيئجاللا 
باتكلا راد						      |	كياتيحلااك
ريرقت قح تانامضو ةـيلاقتنالا ةرتفلا ءاـنثا ةماعلا تايحالصلا م |	ريرقت قح تانامضو ةيلاقتنالا ةرتفلا ءانثا ةماعلا تايحالصلا ميظ
يف مهتمالس ةيسنرفلا ةـموكحلا نمضت نا ىلع ،رئازجلا يف لاتقلا ف |	يف مهتمالتس ةينرفلا ةموكحلا نمضت نا ىلع ،رئازجلا يف لاتقلا فق
،رادقمب رومألا نأ تنقيتساو ،راتقإلا نم فاخت ام تنمأ لوقعلا نع |	،رادقمب رومألا نأ تنقيتساو ،راتقإلا نم فاخت ام تنمأ لوقعلا نع
. طسابلا دبع ،يفوصلا					      |	. طسابلا دبع ،ينوصلا
أدبت هرفطلا نانظيو . تانيجلا رغصل هتيؤر نكمي ال تانيجلا ةعيبط |	أدبت هرفطلا نا نظيو . تانيجلا رغصل هتيؤر نكمي ال تانيحلا ةعيب
الو . یلابحلا ءيق نمو رحبلا راود نم يفشي رخآ جالع ىلعو ،ةقهشل |	الو . ىلابحلا ءيق نمو رحبلا راود نم يفشي رخآ جالع ىلعو ،ةقهشل
: ةيسايسلاو ةيعامتجالا فورظلا ببسب ةعئاضلا ةيرشبلا دراوملا :ً  |	: ةيسايسلاو ةيعامتجالا فورظلا ببسب ةعئاضلا ةيرشبلا دراوملا : ً
مدع ةثورحملا يضارالا يف ناكسلا ةفاثك نع ةجتانلا ةلاحلا ةروطخ  |	مدع ةثورحملا يضارالا يف ناكسلا ةفاثك نع ةجتانلا ةلاحلا ةروطخ 
. قارعلا كلم ينانلا لصيف كلملا				      |	. قارعلا كلم ينانلا لصيف ؟كللملا
هـنا مهملعاو اريـخ مهدعوف مهربخ لكب هوربخاف ،مهدالب نیاو اوؤا |	هنا مهملعاو اريخ مهدعوف مهربخ لكب هوربخاف ،مهدالب نياو اوؤاج 
٥٥ . . . . . . . . . . . . . . . . . . . . . . . . . . . . .  |	٥٥ . . . . . . . .. . . . ... ..... ... ...... عقاولاو لاثملا
هنع لالقاب لصاوت نم ةدج مدتسا . ٣٥٨ .			      |	. هنع لالقاب لصاوت نم ةدج مدتسا . ٣٥٨
درويو ١٩١٦ ةنس يف برعلل اهسفن ىلع ابيناطيرب اهتعطق يتلا تاماز |	درويو ١٩١٦ ةنس يف برعلل اهسفن يلع ايناطيرب اهتعطق قيتلا تاماز
. ١٩٥٨/٧/٣٠ خيراتب ةيرذلا ةقاطلا ةنجل ،٤٥٣/م مقرب ةركذملا : ع |	. ١٩٥٨/٧/٣٠ خيراتب ةيرذلا ةقاطلا ةنجل ،٤٥٣/م مقرب ةركذملا : ع
نم اجاوما نا كلذ للعيو ،علهلاو قرعلا ببصتو بلقلا ناقفخ هلئالد |	نماجاوما نا كلذ للعيو ،علهلاو قرعلا ببصتو بلقلا ناقفخ هلئالد 
دقلو هسفن عنصملا يف لـمعلا بحاص دي ىلع ذملتتلاب یمسي ام وا ًاد |	دقلو هسفن عنصملا يف لمعلا بحاص دي ىلع ذهلتتلاب ىمسي ام وا ًادي
. يبرعلا ملاعلا نمً ادحوا ًاءزج عوضوملا لمشي ناب یفتکال الاو ،ك |	. يبرعلا ملاعلا نم ًادحاوً اءج عوضوملا لمشي ناب ىفتكال الاو ،كل
،١١ ىلاعت هللا دارم ةفرعم ءازإب لاحلا رسو ،هب ملاعلا ةقيقح ءا |	،٢١ ىلاعت هللا دارم ةفرعم ءازإب لاحلا رسو ،هب ملاعلا ةقيقح ءا
. اذكهو اهيلت يتلاف ،ً اينازم ةقباسلا ،ً ايلعم ةنكمملا ،ًايئدبم  |	. اذكهو اهيلت يتلاف ،ًاينامز ةقباسلا ،ًايلمع ةنكمملا ،ًايئدبم مه
عم اـنتراجت ةراسخل نيدعتسم نوكن نا نم لاحلا كلت يف انل دب ال  |	عم انتراجت ةراسخل نيدعتسم نوکن نا نم لاحلا كلت يف انل دب ال ا
. اًلهاجتمو ًاتكاس هدجت ليئارسا ةعمس ىلا ءيسي رما دجو امثيحو ،ل |	. اًلهاجتمو ًاتکاس هدجت ليئارسا ةعمس ىلا ءيسي رما دجو امنيحو ،ل
١٩ ةفص - فوصوم هيلإ فاضم - فاضم رورجم ـ راج فم ـ اف - ف ١     |	١٩ ةفص - فوصومم هيلإ فاضم - فاضم رورحب راج فم - اف ف ١
هل عضخي ًاـتباثً امانظ ملاعلا يف ناب يعيبطلا نوناقلاب نونمؤملا  |	هل عضخي ًاتباثً اماظ ملاعلا يف ناب يعيبطلا نوناقلاب نونمؤملا لا
توريب يف ةيكريمألا ةعماجلا اـهردصت ةلجم			      |	توريب ف ةيكريمألا ةعماجلا اهردصتلجم
. مامالأ ىلا ةيندملا عفدي نأو ةننوكلاو نوكلا قيرط	      |	. مامالا ىلا ةيندملا عفدي نأو ةننوكلاو نوكلا قيرط
. بيجن دمحم ماعلا دئاقلاو يكريمالا ريفسلاو اشاب رهام يلع سيئر |	. بيجن دمحم ماعلا دئاقلاو يكريمالا ريفسلاو اشاب رهام ىلع سيئر
اهمضل ةعماجلا نع ندرالا لصف ةيبرعلا ةعماجلا ةسلج يف رصم تحرتق |	اهمضل ةعماجلا نع ندرالا لصف ةيبرعلا ةعماجلا ةسلج يف رصم تحرتق
ءاسؤرلا ءالؤه ناو ،ينامثعلا دهعلا یلا دوعي يسايس خيرات تاذ ةر |	ءاسؤرلا ءالؤه ناو ،ينامثعلا دهعلا ىلا دوعي يسايس خيرات تاذ ةر
ىأر نم لواو . رطفلا روذبو ةريمخلا ايالخ اوأرو ةملاسملاو ةراضل |	ىأر نم لواو . رطفلا روذبو ةريخملا ايالخ اوأرو ةملاسملاو ةراضل
: ةيلاتلا ماكحالا نم ودبي امك ةيمكلا ثيح نم فيلستلا ديدحت :ً ا |	: ةيلاتلا ماكحالا نم ودبي امك ةيمكلا ثيح نم فيلستلا ديدحت : ًا
امنأكف ،لح ىلا لوصولل القتسم اقالخ ًادهج نيئجاللا ةيضق ءاليا ى |	امناكف ،لح ىلا لوصولل القتسم اقالخ ًادهج نيئجاللا ةيضق ءاليا ى
قح يف الإ روصتي ال ةحاسملا برق نألً اضأي لهج اذهو ،هيلإ تادوجو |	قح يف الإ روصتي ال ةحاسملا برق نأل ًاضأي لهج اذهو ،هيلإ تادوجو
هـيخأب لـيلخ لک الخو					      |	هيخاب ليلخ لك الخو
مجعم : اهنم ،ًابتك فنصو نوريثك طخلا هنع ذخأ . دادغب لهأ نم ،يس |	مجعم : اهنم ،أأبتك فنصو نوريثك طخلا هنع ذخأ . دادغب لهأ نم ،ي
ةسايسلل مت اذا هناف اذهلو . ةراسخب انايحا اهعيبو جراخلا ىلا م |	ةسايسلل مت اذا هناف اذهلو . ةراسخبانايحا اهعيبو جراخلا ىلا مه
ليواقألاو ،ةيحان نم رشلاب وأ ريخلاب لصتت ةملك نع ربعتوً المث ب |	ليواقألاو ،ةيحان نم رشلاب وأ ريخلاب لصتت ةملك نع ربعتو ً الثم 
يساسالا ماظنلا اذـه يف اهيلع صوصنملا هتايحالص كلملا ةسراممل ة |	يساسألا ماظنلا اذه يف اهيلع صوصنملا هتايحالص كلملا ةسراممل ةم
١٩٦٤ ،توريب - نیيالملل ملعلا راد : رشن			      |	١٩٦٤ ،توريب - نييالملل ملعلا راد : رشن
دالب ىلا يهتنت یتح رهشا ةثالث ریستف رحبلا بكرت ةنيدملا هذه نم |	دالب ىلا يهتنت ىتح رهشا ةثالث ريستف رحبلا بكرت ةنيدملا هذه نم
هرايتخا نا امك ،رصع نود رصع ىلع وا ،دلب نود دلب ىلع ةداجالا ر |	هرايتخا نا امک ،رصع نود رصع ىلع وا ،دلب نود دلب ىلع ةداجالا ر
يبرـعلايملـعلا ركـفلا روطت				      |	يرحلاهاعلاراهيلا روطت
. دالبلا						      |	. هالبلا
. نامع يف يناطيربلا لخدتلا دض ةدحتملا ممالا ىلا ًاجاجتحا ةيقير |	. نامع يف يناطيربلا لخدتلا دض ةدحتملا ممالا ىلاً اجاجتحا ةيقير
. ص ٢٩٩ . ١٩٥٨ ،ةيريمالا				      |	. ص ٢٩٩٦ . ١٩٥٨ ،ةيريمالا
. لخدلا ىوتسم طوبه متحتيف فيظوتلاو			      |	. لخدلا ىوتسم طوبه محتيف فيظوتلاو
نويع ناهرلا موي اهب تقلع اـهنا ال اـهقبس ةعاسب تفرع	      |	فنويع نامرلا موي اهب تقلع اهنا ال اهقبس ةعاسب تفرع
تضق ثيحب ينامورلا مالسلا بابشلا دهع يف ةيريشبتلا برحلا تطشن د |	تضق ثيحب ينام ورلا مالسلا بابشلا دهع يف ةيريشبتلا ب رحلا تطشن
يفو ريصملا ريرقت يف نيينادوسلا قحبً اديوط ًاناميا ةيرصملا ةموكح |	يف وريصملا ريرقت يف ئنيينادوسلا قحب ًاديطو ًاناميا ةيرصملا ةموك
هبولساو . حالصالا لجا نم ةقداص ةينطو ةبغرب هتجلاعم يف عوفدم ف |	هبولساو . حالصالا لجا نم ةقداص ةينطو ةبغرب هتحلاعم يف عوفدم ف
ليوحت قيرط نع ةرداصلا اـهتراجت عيونت ىلا ءاضعالا لودلا دمعت ن |	ليوحت قيرط نع ةرداصلا اهتراجت عيونت ىلا ءاضعالا لودلا دممت نأ
نانبل - توريب						      |	نابل - توزيج
هيلا بتک امدنع عوضوملا اذه يف هتالو دحا یلا يلع مامالا ةحيصن  |	هيلا بتک امدنع عوضوملا اذه يف هتالو دحا ىلا يلع مامالا ةحيصن 
لمحتتل ةيعيرشتلا سلاجملا هذه ةيوقت مويلا ةيطارقميدلا تابجاو م |	لمختتل ةيعيرشتلا سلاجملا هذه ةيوقت مويلا ةيطارقميدلا تابجاو م
تاريخلا هذه ىلع اولصحيل مهعسو يف اـم لك اولمعي نا مهبولق يف ا |	تاريخلا هذه ىلع اولصحيل مهعسو يف ام لك اوامعي نا مهبولق يف او
وا ةلادعلا ققحيل نكي مل ماظنك وهو . سسالا هذه هل اـملاط كلذ س |	وا ةلادعلا ققحيل نكي مل ماظنکك وهو . سسالا هذه هل املاط كلذ س
١٩٢٦ العلا ةعبطم ،ةرهاقلا - قرشلا اهياً اعاود		      |	١٩٢٦ العلا ةعبطم ،ةرهاقلا - قرشلا اهيا ًاعادو
ررحم يتيام نم برقي ام ةيكريمالا دئارجلا ضعب ريرحت مسق يف تدها |	زرحم يتیام نم برقي ام ةيكريمالا دئارجلا ضعب ريرحت مسق يف تدها
حالص روتکدلاب اکیرما ةيجراخ ريزو نوسيشتا رتسملا عمتجا - ٥٠ -  |	حالص روتكدلاب اكيرما ةيجراخ ريزو نوسيشتا رتسملا عمتجا - ٥٠ - 
يف مكحلا نولوتي نوبختنملا ةنراوملا ةكراطب ناك امك . نييباهشلا |	يف مكحلا نولوتي نوبختنملا ةنراوملا ةكراطب ناك امك . نييباهشلا
خيرات يف نيسلجم يف وأ دحاو سلجم يف ًاعم امهل اهداهشإ ناك له ىر |	خيرات يف نيسلجم يف وأ دحاو سلجم يفًاعم امه اهداهشإ ناك له يردي
،رظتني ناك امم ريثكب لقا ةلفحلا ىلع لابقالا ناك ذا ،ةسوكعم ةج |	،رظتني ناک امم ريثكب لقا ةلفحلا ىلع لابقالا ناکذا ،ةسوكعم ةجي
،ةرهاقلا ... ةعيرشلا ماكحا يف ةعيشلا لئاسو باتکل عماجلا وهو ا |	،ةرهاقلا .. . ةعيرشلا ماكحا يف ةعيشلا لئاسو باتكل عماجلا وهو 
ًاحاحلإ دشا ليماسرلا ىلا ةجاحلا تحبصا نيئجاللا ليس قفدتبو . اه |	ًاحاحلا دشا ليهاسرلا ىلا ةجاحلا تحبصا نيئجاللا ليس قفدتبو . اه
ريبكلا جاتنالا نمضتي ينفلا ءامنالا نا ريغ . ةدحتملا تايالولاو |	ريبكلا جاتنالا نمضتي ينفلا ءامنالا نا ريغ . ةدحتملا تالايولاو
. ص ١٤٢							      |	. ص ١٤ ٢
يتلا طورشلا يف رئازجلاو اسنرف نيب نواعت مايق نوديري اوناک اذا |	يتلا طورشلا يف رئازجلاو اسنرف نيب نواعت مايق نوديري اوناك اذا
نا بجي ةرضاـحلا دوهجلا فده نا ىلع ًاـعيمج فارطالا عم قافتا ىلا |	نا بجي ةرضاحلا دوهجلا فده نا ىلع ًاعيمج فارطالا عم قافتا ىلا ل
٢٥١٠٢ : نوفلت - ءارمحلا عراش				      |	٢٠١ ٢: نوفلت - ءارمحلا عراش
ةيلهالا ةسسؤملا ،توريب - یرخا صصقو قرع			      |	ةيلهالا ةسسؤملا ،توريب- ىرخا صصقو قرع
ةغللا لخدت يتلا ةديدجلا يناعملا نا ظحالن ةيناث ةهج نمو	      |	ةغلا لخدت يتلا ةديدجلا يناعملا نا ظحالن ةيناث ةهج نمو
. فزوج ،لزیغم						      |	. فزوج ،لزيفغم
١٩٦٦ ناسین - ١٩٦٥ يناثلا نيرشت				      |	١٩٦٦ ناسين - ١٩٦٥ يناثلا نيرشت
اـهتاهاجتاو ليئارسا نع تامولعملاب ينغ وهو . ًانلع هلوقي نا يدو |	اهتاهاجتاو ليئارسا نع تامولعملاب ينغ وهو . ًانلع هلوقي نا يدوه
ةيبرعلا كلامملا ىلع اولوتساو ،يبرعلا ناطلسلا ضارقنا دعب ًاريخا |	ةيبرعلا كلامملا ىلع اولوتساو ،يبرعلا ناطلسلا ضارقنا دعبً اريخا
لامکلا ةروص ةـنمآ ةديسلا يف اوأر موق انل هفلخ ام يه راثآلا كل |	لامكلا ةروص ةنمآ ةديسلا يف اوأر موق انل هفلخ ام يه راثآلا كلت
ىلا طيحملا نم قيرط وه اهنم عاعش لكو . قرطلا ىلا زمرتف هعشالا  |	ىلا طيحملا نم قيرط وه اهنم عاعش لکكو . قرطلا ىلا زمرتف هعشالا
ثارتلا ءايحإ راد ،توريب ،نيفلؤملا مجعم ،ةلاحك اضر رمع رظنا .  |	ثارتلا ءايحإ راد ،توريب ،نيفلؤملا مجعم ،ةلاحك اضر رمع رظنا . 
تاعورشملاا هذه ذيفنت متي فيك . . وه لاجملا اذه يف هتراثا نم د |	تاعورشملا هذه ذيفنت متي فيك . . وه لاجملا اذه يف هتراثا نم دب
ةيبروالاو ةيبرعلا لودلا ريتاسد ىلع تعلطا ةيعمجلل ةعباتلا ةفلت |	ةيبروالاو ةيبرعلا لودلا ريتاسد ىلع تملطا ةيممجلل ةعباتلا ةفلت
اـهيمسي ةيبرتلا نم ًاعون يسابعلا رصعلا يف كانه نا ىري اًلثم يتح |	اهيمسي ةيبرتلا نمً اعو يسابعلا رصعلا يف كانه نا ىري اًلثم يتح ر
هيلع تناك امب ١٩٤٧ ةنس ةعانصلا لقح يف يرصملا لماعلا ةيجاتنا ت |	هيلع تناك امم ١٩٤٧ ةنس ةعانصلا لقح يف يرصملا لماعلا ةيجاتنا ت
. ١ ج . ١٩٦٤ ،ةايحلا ةبتكم راد ،توريب . وده ديجم ديمح هيلع قل |	. ١ج . ١٩٦٤ ،ةايحلا ةبتكم راد ،توريب . وده ديجم ديمح هيلع قلع
دعب ىلع تنكسو تارفلا ةدلولا ةريشع تويب نم تائم تزاتجا ١٨٦٠ ةت |	دعب ىلع تنكکسو تارفلا ةدلولا ةريشع تويب نم تائم تزاتجا ١٨٦٠ ة
بولسال ًارظن اھتعجارم نـم ءيراقلا لـمي الو زاجياب ةيخيراتلا ثد |	بولسالً ارظن اهتعجارم نم ءىراقلا ل ممي الو زاجياب ةيخيراتلا ثد
ىوقا نوكي ةساردلا ىلع لاـبقالا ناب قثاو يننا . ةرضاحلا انلکاش |	ىوقا نوکي ةساردلا ىلع لابقالا ناب قثاو يننا . ةرضاحلا انلكاشم
. هيف مهكامسأ نوعيبي رخآ عضوم ىلا نورجهيو كامسألا	      |	. هيف مهکامسأ نوعيبي رخآ عضوم ىلا نورجهيو كامسألا
وكسوم يف ةدحتملا ةيبرعلا ةيروهمجلا ةرافس نع ردص نايب يف ملاس  |	وكسوميف ةدحتملا ةيبرعلا ةيروهجلا ةرافس نع ردص نايبيف ملاس حال
نم ةـيا . دراوملا نم ددع ربکا ىلع رطيست يھف ،يعامتجالا لمعلا  |	نم ةيا . دراوملا نم ددع ربکا ىلع رطيست يهف ،يعامتجالا لمعلا ي
زوجي ال ذا ،اهدادعت رركي الا يهيدبلا نمو . ناكدلا بحاصو زابخل |	زوجي ال ذا ،اهدادعت رركياألا يهيدبلا نمو . ناكدلا بحاصو زابخل
ال نيذلا ليجانالاو ةاروتلا ءاملع ددع نوكي نا ىشخاو . ةىيخيرات |	ال نيذلا ليجانالاو ةاروتلا ءاملع ددع نوكي نا ىشخاو . ةيخيراتل
راطخا ءردو نزخلاو فيرصتلاو يرلا عيراشم نع ًادج ةرصتخمب ةرظن هذ |	راطخا ءردو نزخلاو فيرصتلاو يرلا عيراشم نع ًادج ةرصتخم ةرظن هذه
ضعب ىلع نيـعلطم اوناک مهف . ةدـماج مأ ةيح تناك اذا امع نييعت  |	ضعب ىلع نيعلطم اوناك مهف . ةدماج مأ ةيح تناك اذا امع نييعت وأ
وھي رما ناک اذهف . تاناويحلا عيمجو مهنم عضرلا ىتح لافطالاو خو |	وهي رما ناک اذهف . تاناويحلا عیيمجو مهنم عضولا ىتح لافطالاو خ
لك لمحي ،اـهسفن ةيرقلا لها نم رثكا وا دحاو صخشل ةيرقلا ماـمز  |	لك لمحي ،اهسنفن ةيرقلا لها نم رثكا وا دحاو صخشل ةيرقلا مابمز 
. مهلكاشملو ةيعامتجالا ةمدخلا لقح يف لامعلل اهسفن سركتو	      |	. مهلكاشملو ةيعامتجالا ةمدخلا لقح يف لايعلل اهسفن سركتو
اذـه يعدتسيو ،دارفالا بيردت هتاقيبطتو هتيمنت يف ملعلا بلطتي : |	اذنه نعدتسيو ،دارفالا بيردت هتاقيبطتو هتيمنت يف ملعلا بلطتي :
. ميهاربا ،هدبع						      |	. ميهاربا ،هدع
. ص ٦٣ . ١٩٦٥						      |	. ص ٦٣ .. ١٩٦٥
ليجلا يف ةركاب ةيلمع يه ةبورعلا ءاحنا عـيمج ىلع تادرفملا ةمئا |	ليجلا يف ةركاب ةيلمع يه ةيورعلا ءاحنا عيمج ىلع تادرفملا ةمئاق
يقالخا فقوم كلذ بحاصي نا ىلع ،ةظحللا هذه خیرات هيف امب - هلک  |	يقالخا فقوم كلذ بحاصي نا ىلع ،ةظحللا هذه خيرات هيف امب - هلك 
،ةيبرعلا راطقالا سرادم يفً اضاي سرديو اسنرفو ارتلكناو ايناملا  |	،ةيبرعلا راطقالا سرادم يف ًاضاا سرديو اسنرفو ارتلكکناو ايناملا
ينبجعي : باوصلاو ينبجعي ١٦ س ١٩ ص			      |	ينيجعي : باوصل/اوو ينبجي ١٦ س ١٩ ص
ةياصو ذيبحت ىلع دقعنم ماعلا يأرلا عامجا نا ،تدجو امف ،ةنجللا  |	ةياصو ذيبحت ىلع دقعنم ماعلا يأرلا عامجا نا ،تدجو اميف ،ةنجللا
. اهلک تارفلا ةظفاحم تحاتجا يتلا سوفيتلا		      |	. اهلك تارفلا ةظفاحم تحاتجا يتلا سوفيتلا
ًاقح ةلهؤملا ،ةحيحصلا رصانعلا ديدجلا ليجلل ءيهن نا اندراو ،ًاضي |	ًاح ةلهؤملا ،ةحيحصلا رصانعلا ديدجلا ليجلل ءيهن نا اندراو ،ً اضي
ناک ناف . ملسوهيلعهللاىلص هللا لوسر رابخا ىلا عوجرلاب وا يحوب |	ناك ناف . يامل هللا لوسر رابخا ىلا عوجرلاب وا يحوب وا هرظنو
یرن اذه یلعو . عماوجلا ءابطخ هغلو تالاهتبالاو تاولصلا ةغلو    |	ىرن اذه ىلعو . عماوجلا ءابطخ هغلو تالاهتبالاو تاولصلا ةغلو
. فـسوـي نـب نسحلا نيدلا لامج ،يلحلا رهطملا نبا		      |	. كتكسوي نبب نسحلا نيدلا لامج ،يلحلا رهطملا نبا
نيبو ٣٨ ضرعلا طخو طسوتملا ضيبالا رحبلا نيب ةيبرغلا ءارحصلا ىف |	نيبو ٢٨ ضرعلا طخو طسوتملا ضيبالا رحبلا نيب ةيبرغلا ءارحصلا ىف
ركف باحصا ونوكي مل مهسفنا كارتالا نال كلذ . يبرعلا ركفلا يف ر |	ركف باحصا ونوكيهل مهسفنا كارتالا نال كلذ . يبرعلا ركفلا يف رث
اولحف ةئيسلا لاحلا كلتب انودجوف انيلا موقلا لبقاف انتلمحي انح |	اولحف ةئيسلا لاحلا كلتب انودجوف انيلا موقلا لبقاف انتلمجب انح
ةيلاطياو ةيفالسغويو ةينانوي نيئجال براضم مكافخي ال امك تماق د |	ةيلاطياو ةيفالسغويو ةينانوي نينجال براضم حافخي ال اك تماق دقف
ريـنلا تحت تعقو يتلا نادلبلا هذه يف راج وه امب ربتعي ال نمو . |	رينلا تحت تعقو يتلا نادلبلا هذه يف رراج وه امب ربتعي ال نمو .
. ةنجلا هللا لسي وهو رحب ... - ٣			      |	. ةنجلا هللا لسي وهو رحب . . . - ٣
هيدلاولاو يثراهلا حابر نب - ٢				      |	هيدلاولاو ين راهلا حابر نب - ٢
اـهنكلو ! قيش لهس سرد نم هل اي ! ةينفلا هنازيمو يلهاجلا رعشلا |	اهنكلو ! قيش لهس سرد نم هل اي ! ةينفلا هتازيمو ىلهاجلا رعشلا 
نطاوملا ىتح همعدي مل اذا ًاقالطا حالصإلا اذـه يرجي ال دقو . سا |	نطاوملا ىتح همعدي مل اذا ً اقالط حالصإلا اذه يرجي ال دقو . سان
. رمالا اذهب ةينعملا نادلبلا عميج ةراشتسا كلذ ولتي نا يغبني ه |	.رمالا اذهب ةينعملا نادلبلا عيمج ةراشتسا كلذ ولتي نا يغبني هن
نوكي ناسنا يال الو انل نكمي ال هنا اهل انحرص ،عورشملا اذه ساس |	نوكي ناسنا يال الو انل نكمي ال هنا اهل انح رص ،عورشملا اذه سا
ةرثكو ناطلسلا يف هتدم لوطلً ارنظ ،هرصاع كلم يأ هربخي مل امك وم |	ةرثكو ناطليلا يف هتدم لوطلً ارظن ،هرصاع كلم يأ هربخي مل امكومح
قيدصتلل داحتالا سجملا ىلع عضي يذلا يونسلا جمانربلاو داحتالا س |	قيدصتلل داحتالا سلجملا ىلع عضي يذلا يونسلا جمانربلاو داحتالا 
١٩٢٢ ،ةرهاقلا - كرتلا دنع برعلا ةنوعرف			      |	١٩٢٢ ،ةرهاقلا - ثاتلا دنع برعلا ةنوعرف
. ٢٣ - ٢٢ و						      |	. ٢٣ - ٢٢و
يأر بسح لـعفلاب تارارقلا ذختتف ،اياضقلا فلتخم لوح مهتاوصاب او |	يأر بسح لهعفلاب تارارقلا ذختتف ،اياضقلا فلتخم لوح مهتاوصاب او
براجت هيلا تهتنا امبسح فيرلا ةمدخل نيئيهمو ادادعا نيدعم اصاخش |	براجت هيلا تهتنا ابسح فيرلا ةمدخل نيئيهمو ادادعا نيدعم اصاخشا
عئاقولا لسلستو ثدحلا ىلع دمتعت يتلا ةيمحلملا لامعألا يف هدهشن |	عئاقولا لسلستو ثدحلا ىلع دمتعت يتلا ةيمحلملا لامعألا يف هدهشن
٣١١ : روثنملاو موظنملا . ٣٥٢ .				      |	. ٣١١ : روثنملاو موظنملا . ٣٥٢
. ديمحلا دبع ،ليدنق					      |	. ديمحلا دبع ،ليدنقت
يسيئرلا اهدصقم نال ،ةقيدص ًابوعش ناينبلا اذه اهنم نوكتي يتلا ب |	يسيئرلا اهدصقم نال ،ةقيدصً ابوعش ناينبلا اذه اهنم نوكتي يتلا ب
. ص ٣٢٧ . ١٩٦٥ ،بتكلا راد ةعبطم ،توريب . ىلوالا ةعبطلا . بازح |	. ص ٣٢٧ . ١٩٦٥ ،بتكلا راد ةعبطم ،توريب . ىلوالا ةعبطلا . بازح
ةرواجملا ممالا نع مالكلا ىلا اهنزواجتي دقو ةيبرعلا دالبلا راب |	ةرواجملا ممالا نع مالكلا ىلا اهنوزواجتي دقو ةيبرعلا دالبلا را
بصنلا تاودا نال ،بصنلا تاودا یدـه ملعت نا ةصلخم تلواح ىده ةمل |	بصنلا تاودا نال ،بصنلا تاودا ىده ملعت نا ةصلخم تلواح ىده ةماع
يف تعقو يتلا ءاطخألا ناف ،ةمجرتلاو ةحيحصلا ةءارقلا لمشيً اجودم |	يف تعقو يتلا ءاطخألا ناف ،ةمجرتلاو ةحيحصلا ةءارقلا لمشيً اجودز
ىلا ىندأو ،ً اريبتع قنآو ،ةغل موقأ ةباتكلا تراصف يملعلا عسوتلا |	ىلا ىندأو ،ًاريبعتت قنآو ،ةغل موقأ ةباتكلا تراصف يملعلا عسوتلا
ةرمغ يف اهفالتخا ىلع مهراثآ ترمطناف دمألا ليوط مظنم داهطضال ا |	ةرمغ يف اهفالتخا ىلع مهراثآ ترمطناف دمألا ليوط مظنم داهطضال ا
نا وه ةـحنجالاو شارفلا نيب قرفلا نكل . ةرئاطلا ةحنجا عطقم هبا |	.نرآ وه ةحجالاو شارنلا نير قرنلا نكأ ةرئانلا ةسجأ علقم هباتي 
،عـيضاوملا ةراثا نا ريغ ،نيملسملا ناهذا يف رودت يتلا ةلئسالا  |	،عيضاوملا ةراثا نا ريغ ،نيملسملا ناهذا يف رودت يتلا ةلئسالا ن
ددجت ،یرخا ةيقافتاب ١٩٢٤ يناثلا نوناك ةيقافتا تلدبتسا ١٩٣٨ ما |	ددجت ،ىرخا ةيقافتاب ١٩٢٤ يناثلا نوناك ةيقافتا تلدبتسا ١٩٣٨ ما
خيراتلا مهفت ىلع امئاق ًافطع اهتيضقو ةأرملا ىلع ًافطع ءالتما دق |	خيراتلا مهفت ىلع امئاقًافطع اهتيضقو ةأرملا ىلع ًافطع ءالتما دق 
١٧ ةحص وهو بلطلا ةضايرو سفنلا عـبط نع جورخلا وهو ،بدألا ةضاير |	١ةحص وهو بلطلا ةضايرو سفنلا عبط نع جورخلا وهو ،بدألا ةضاير : 
٢٢٥ - ٢٠٠ ١٤٧ ٠٤٤ ١٩٥١ يناثلا نوناك			      |	٢٢٥ - ٢٠٠ ١٤٧ ٤١٤٠ ١٩٥١ يناثلا نوناک
؛ ةلودلا ةدايس ةيرظن : ةيسيئر مئاعد ثالث ىلع يبرغلا ةلودلا ما |	؛ ةلودلا ةدايس ةيرظن : ةيسيئر مثاعد ثالث ىلع يبرغلا ةلودلا ما
. عباسلا يندرالا ةمالا سلجمل ىلوالا ةيداعلا ةرودلا نيسح كلملا |	. عباسلا يندرالا ةمالا سلجمل ىلوالا ةيداعلا ةرودلا نيسح كلملا
. دنهلا ىلا ةبوسنم يهو ،٩٨٧٦ ٤٣٢١			      |	. دنهلا ىلا ةبوسنم يهو ،٩ ٨ ٧ ٦ ي ١ک ٣٢ ١
نيتئام ىلاوح ةدوع ىلع تقفاو ليئارسا نا سدقلا يف ةندهلا ةبقارم |	نيیتئام ىلاوح ةدوع ىلع تقفاو ليئارسا نا سدقلا يف ةندهلا ةبقار
دقتعنو جرم اهانعم ? يقسلا لبإ ینعم ام ،لمملا ليوطتلا اذه دعب  |	دقتعنو جرم اهانعم ? يقسلا لبإ ىنعم ام ،لمملا ليوطتلا اذه دعب 
تنا فيكف ،ءاـيعلا ىتح قهرم ! ةقيدص اي انا		      |	تنا فيكف ،ءايعلا ىتح قھرم ! ةقيدص اي انا
. ص ٨٢ . ت . ال ،رشنلاو ةعابطلل ةيموقلا رادلا ،ةرهاقلا . نويد |	، ص ٨٢ . ت . ال ،رشنلاو ةعابطلل ةيموقلا رادلا ،ةرهاقلا . نويد
باستكا فولالا ىلع كلذب تلهسو ،عساو قاـطن ىلع سرادملا ةماقا يف |	باستکا فولالا ىلع كلذب تلهسو ،عساو قاطن ىلع سرادملا ةماقا يف 
ةيرامعتسالا رشع عساتلا نرقلا ةسايس قيبطت يف رارمتسالا يلا ةـي |	ةيرامعتسالا رشع عساتلا نرقلا ةسايس قيبطت يف رارمتسالا ىلا ةيم
. ةدحتملا ةكلمملا ىف ةكلملا				      |	. ةدحتملا ةكلمملا يف ةكلملا
ةيفاضالا عفاـنملاو تادايزلا اهيلا فيضا اـم اذاً ارالدو ٦٠٠٠ ىل |	ةيفاضالا عفانملاو تادايزلا اهيلا فيضا ام اذا ًارالود ٦٠٠٠ ىلا 
حالفلا ناعجشي ال نالماع امه ،ةلغلا نم ةنيعم ةصح راجيالا نوك و |	جحالفلا ناعجشي ال نالماع امه ،ةلغلا نم ةنيعم ةصح راجيالا نوکو
. ص ٦٤٣ . ١٩٦٢ ،ةطبارلا ةعبطم ،دادغب			      |	. ص ٦٤٣ . ١٩٦٢ ،ةطبارلا ةعيطم ،دادغب
امك ،مهردق كانه ةطرشلا يف اـفظوم نا ريغ . ٢٥٠٠ـب ١٩٦٠ ماع نوي |	امک ،مهردق كانه ةطرشلا يف افظوم نا ريغ . ٢٥٠٠ ب ١٩٦٠ ماع نويل
راـمدلا ىوس يناسنالا ملاعلل مدقت الف ،ةيراضح ةيناكما لك ةوذج  |	رامدلا يوس يناسنالا ملاعلا مدقت الف ،ةيراضح ةيناكما لك ةوذج ا
ةيرح ىلا وه ةماع ةيناسنالا هاجتاف . هنمً اغورفومً افورمع نوكي د |	ةيرح ىلا وه ةماع ةيناسنالا هاجتاف . هنم ً اغورفمو ً افورعم نوكي
. مداخو ةضرمم وا ضرممو بيبط اهنم لک يف ًافصوتسمو ًازك رم ١٤٠ نع |	. مداخو ةضرمم وا ضرممو بيبط اهنم لك يفً افصوتسمو ًازكرم ١٤٠ نع 
رصم خيرات هيلا فاضاو بیليف يول رصع ىتح اسنرف خيرات يفً اباكت د |	رصم خيرات هيلا فاضاو بيليف يول رصع ىتح اسنرف خيرات يفًاباک دوع
كلذكو . نيينعملا ضارقنا دعب نييباهشلا ىلا ةرامالاب دهع ةيناقم |	كلذكو . نيينعملا ضارقنا دعب نييباهشلا ىلا ةرامالاب دهع ةيناقم
كلاذب نوكي هنأل ءيش هل نكي مل ناقح امهن : لاقوً اعيجم نادهاشلا |	كلذب نوكکي هنأل ءيش هل نكي مل ناقح امهنا : لاقو ًاعيمج نادهاشل
٧،٥٨ ٢٥،٢٥ يساسالا رجالا				      |	٧،٥٨٥٨٥ ٢،٢٥٥ يساالا رجالا
. نيساسب صمقت دوقرم وه : سيدقلا اذه رما نم ينرماخي ام كل تلق  |	. نيساسب صمقت دوقرم وه : سيدقلا ذه رما نم ينرماخي ام كل تلق ا
،بسحف ولرتاو يف نويلبان ةميزه يف مهاست نا عطتست مل اهنا ثيحب ً |	،بسحف ولرتاو يف نويلبان ةميزه يف مهاست نا عطتست مل اهنا ثيحب ً
. ةمالسلاو ةطاسبلا ىلا رعقتلاو بانطالا نعً اديروً اديرو تلامو ، |	. ةمالسلاو ةطاسبلا ىلا رعقتلاو بانطالا نعً اديورً اديور تلامو ،
ناـجللا لمعتو تاعامتجالا دقعتو تارضاحملا اهيف ىقلتو اليوط هذه |	ناجنللا لمعتو تاعامتجالا دقعتو تارضاحملا اهيف ىقلتو اليوط هذه
. ديري ام ىلع ةردق یذ نييهتسم كلم			      |	. ديري ام ىلع ةردق يذ نييهتسم كلم
٢٥ . . . . . . . . . . . . . . . . . . . . . . . . . . . . .  |	٢٥ .. . . ٥٥٥٥٥٥.مألا ةيبرعلا ةغللاو
. دمحم دمحا ،يسانكلا					      |	. دمحم دمحا ،ىسانكلا
يتلا تالقنتلا ةرثك هيلا تدا يذلا صصختلا مدع نع ًاجتان تارازولا |	يتلا تالقنتلا ةرثك هيلا تدا يزلا صصختلا مدع نع ًاجتا تارازولا 
. سانلا ريهامج لوانتم يف نوكي اًلقن ةفاقثلا لقنت يتلا ةديحولا  |	. سانلا ريهامج لوانتم يف نوكي اًلقن ةفاقثلا لقنت يتلا ةديحولا 
نورصتقي مهنکلو مالسالا روهظ یتح ةقيلخلا ذنم ملاعلا خیرات نع م |	نورصتقي مهنكلو مالسالا روهظ ىتح ةقيلخلا ذنم ملاعلا خيرات نع م
ذئنيح ةيلمعلا متتف ،رغاش ءلم عـيفرتلا اهيف ربتعي ال ىتلا تالا |	ةكاح ةيلمعلا متف ،رغاش ءلم عيفرتلا اهيف ربتعي ال يتلا تالاحلا
١٩٢٦ ةرهاقلا ةعبطم ،ةرهاقلا - یرخا صصقو سويجرس انوبا	      |	١٩٢٦ ةرهاقلا ةعبطم ،ةرهاقلا - ىرخا صصقو سويجرس انوبا
. نوعمش ليمك سيئرلا					      |	. نوعمش ليیيمك سينئرلا
كلذلو . مهیلع نيفرشملاو مهفئاظو نيبو مهنيب ةلصلا نيبردتملا دـ |	كلذلو . مهيلع نيفرشملاو مهفئاظو نيبو مهنيب ةلصلا نيبردتملا دق
يتلا بيردتلا عاونا ضعبلً ارارتك ناک اـهيف بيردتلا نا ١٩٥٣ عيبر |	يتلا بيردتلا عاونا ضعبل ًارارک ناك اهيف بيردتلا نا ١٩٥٣ عيبر ي
. ص ٢٧٩ . ١٩٦٠ ،ءارهزلا ةعبطم ،دادغب . هجهنمو هلامعا ،يديهارف |	. ص٢٧٩ . ١٩٦٠ ،ءارهزلا ةعبطم ،دادغب . هجهنمو هلامعا ،يديهارفل
١ فوصوم - ةفص فاضم - هيلإ فاضم رورجم - راج فم - اف - ف ٣      |	١ فوصوم - ةفط فاضم -هيلإ فاضم رورجم - راج فم - اف ف ٤٢
بتك اـهنيبو بتكلا نومجرتي هذيمالتو ةعافر ذخاو يواطهطلا ةعافر  |	بتک اهنيبو بتكلا نومجرتي هذيمالتو ةعافر ذخاو يواطهطلا ةعافر د
: يلي امب ةتقوملا ةيذيفنتلا ةطلسلا فلكتيس - ش		      |	: ىلي امب ةتقوملا ةيذيفنتلا ةطلسلا فلكتيس - ش
يذ لک بلق هب بلجتست لطابلاب قحلا تهوم يتلا ،داسفلاب ةبراضلا   |	يذ لك بلق هب بلجتست لطابلاب قحلا تهوم يتلا ،داسفلاب ةبراضلا
فارتعا ىلا مث ،رصم يف مدقتلا يحاون ضعب ىلا ريشيل لقتني انه نم |	فارتعا ىلا مث ،رمم يف مدقتلا يحاون ضعب ىلا ريشيل لقتني انه نم
فراعملا ليبس يف ايدوعس الاير ٧ و ٠٢٢ و ٢٢٤ ةنسلا هذه لالخ يف  |	فراعملا ليبس يف ايدوعس الاير ٧و٠ ٢٢و٢٢٤ ةنسلا هذه لالخ يف قفن
سرامت يتلا ةـئيهلا وا صخشلا ةكلمملا نع هبايغ ةلاح يف ،موسرمب  |	سرامت يتلا ةئيهلا وا صخشلا ةكلمملا نع هبايغ ةلاح يف ،موسرمب ك
ساـنلل مجارت ىلع يوتحي رخآ مسق يرمعلا باتك نم يفارغجلا مسقلا  |	سانلل مجارت ىلع يوتحي رخآ مسق يرمعلا باتک نم يفارغجلا مسقلا ي
يف ةرثعبو ةياغلا يف شيوشت كلذ نع جتن ،ةينامزلا ةيقبسالاو ،ناك |	يف ةرثعبو ةياغلا يف شيوشت كلذ نع جتن ،ةينامزلا ةيقبسالاو ،ناك
رثأتسي امنيب ،اسنرف كنب یدل مسحلا لدعم نع ةئاملاب نينثا صقنت  |	رثأتسي امنيب ،اسنرف كنب ىدل مسحلا لدعم نع ةئاملاب نينثا صقنت 
ًالدعا ًاقحمً افيرتص اهفرصي نا نيفظوملا ناويد عـيطتسي يتلا قوقحل |	ًالداع ًاقحمًافيرصت اهفرصي نا نيفظوملا ناويد عيطتسي يتلا قوقحلا 
ًاينف اًليلمع اًلكش ةساردلا ذختت ةقيرطلا هذهبف . ةيسردم ةرشن راد |	ًاينف اًليلمع ةلكش ةساردلا ذختت ةقيرطلا هذهبف . ةيسردم ةرشن راد
ًابئان يلكشيشلا بيدا ديقعلا ةيمستب رخآ موسرم ردصو ءارزولا سلجم |	ًابئان لكشيشلا بيدا ديقعلا ةيمستب رخآ موسرم ردصو ءارزولا سلجم 
. دالبلا ءاحنا فلتخم يف ىرخا ةينارمع			      |	. دالبلا ءاحنلا فلتخم يف ىرخا ةينارمع
. يفاقتلا صلجملا - ج . يداصتقالا سلجملا - ب . عافدلا سلجم - ا |	. يناقتلا صلجملا - ج . يداصتقالا سلجملا -  ب . عافدلا سلجم - 
. ٨ ةداملا ًاصوصخ قافتالا				      |	. ٨ةداملا ً اصوصخ قافتالا
. ص ١٢٥ . ١٩٦٤ ،نماضتلا راد ،دادغب . ميدقلا قارعلا يف ةفريصلا |	. ص ١٢١ . ١٩٦٤ ،نماضتلا راد ،دادغب . ميدقلا قارعلا يف ةفريصلا
قلعتي اميف ةردابملا هذهل ةجيتن ةلداـبتملا لئاسرلا ميمعت اًلعف  |	قلعتي اميف ةردابملا هذهل ةجيتن ةمابتملا لئاسرلا ميمعت اًلعف مت
. نوبتکی ام ةيلوؤسم مهدحو نولمحتي نيذلا اهيفلؤم ءارآ ىنبتت ال |	. نوبتكي ام ةيلوؤسم مهدحو نولمحتي نيذلا اهيفلؤم ءارآ ىنبتت ال
ملو مهتديقع يف اوتبث مهنا ريـغ ،ةفولأملا قلخلا تافصو اهتافص ن |	ملو مهتديقع يف اوتبث مهنا ريغ ،ةفولأملا قلحلا تافصو اهتافص ني
،ةيعامتجالا ةلادعلا قيقحت وحن مراص يعس لظ يف الا متي نا نكمي  |	،ةيعامتجالا ةلادعلا قيقحت وحن مراص يعس لطوف الا متي نا نکمي ا
ةيركسعلا ةريللاو ،نازف يف يرئازجلا كنرفلاو ،ةقرب يف يرصملا هن |	ةيركدسعلا ةريللاو ،نازف يف يرئازجلا كنرفلاو ،ةقرب يف يرصملا ه
. یملس ،غـیاص						      |	. ىیملس ،غياص
لخدي نا بجي ءيشک امناو . ةينايز وا ةيلامج ةميق هل ءيشك ملعلا  |	لخدي نا بجي ءيشك امناو . ةينايز وا ةيلامج ةميق هل ءيشك ملعلا 
. ةيقذاللا يف يفوت . ٨٨٣١ ماع ةناتسالا يف ىناهاشلا يبطلا      |	. ةيقداللا يف يفوت . ١٨٨٣ ماع ةناتسالا يف يناهاشلا يبطلا
قوقح نأشب ،اـهب رخآلا فرطلا ةبلاطم هنكمي يتلا بيلاطملا عيمج ن |	قوقح نأشب ،اهب رخآلا فرطلا ةبلاطم هنكمي يتلا بيلاطملا عيمج نعً
اـصرفلا هنم راهزاللا بهنت				      |	اصرفلا هنم راهزالا بهنت
[لوالا نيرشت ٢٢/٦ : رطسلا قوف] هتس موي ىناسلا عـيبر رهش يف نا |	][لوالا نيرشت ٢٢ / ٦ : رطسلا قوف] هتس موي ىناسلا عيبر رهش يف 
ءاضيبو ءارمح نافصن ةقرخ مهتيار تناکو ةلمرث نب كيهن كع ةيار ىل |	ءاضيبو ءارمح نافصن ةقرخ مهتيار تناكو ةلمرث نب كيهن كع ةيار ىل
. ص ١٨٣							      |	. ص ١٨٢٣
٥/١٠ ةعمجلا اربوالا					      |	٥/١٠ ةعمجلا لايبوالا
نيينادوسلل اهلالخ ةدايسلا				      |	نيينادوسلل اهللخ ةدايسلا
نررالا تناكو . ةيليئارسالا يضارالا ىلا نيراحسلا ةليبق نم لحرل |	نررالا تناكو . ةيليئارسالا يضارالا ىلا نيراحسلا ةليبقت نم لحر
. هفيلح بلط نم هجاتنتسا نكمیو				      |	. هفيلح بلط نم هجاتنتسا نكميو
. نانبل ،توریب ،توریب يف ةيكريمالا ةعماجلا ،ثاحبألا ریرحت سيئ |	. نانبل ،توريب ،توريب يف ةيكريمالا ةعماجلا ،ثاحبألا ريرحت سيئ
يتلا دقارملاو ريثک دراب ءام برش دعب اميسال ًاعيرس ماعطلا بقعب  |	يتلا دقارملاو ريثك دراب ءام برش دعب اميسالً اعيرس ماعطلا بقعي 
ةعانص - ٧ ةريبلا ةعانص - ٦ تويزلا رصع ةعانص - ٥ تنمسالا ةعانص |	ةعانص - ٧ ةريبلا ةعانص - ٦ تويزلا رصع ةعانص - ٥ تنمبسالا ةعان
ةدحتملا ةيبرعلا ةيروهمجلا ةموكح ىلا تبلط اهنا ةيقارعلا ةيجراخ |	ةدجتملا ةيبرعلا ةيروهمجلا ةموكح ىلا تبلط اهنا ةيقارعلا ةيجراخ
ةعبارلا ةجردلا ١٢٦٣ ٢٨٩٧ ١٧٢٧ ١٦٨٤			      |	١٦٨٤ ١٧٢٧ ٢٨٩٧ ١٢٣٥ ةمعبارلا ةجردلا
ضعبو ييايفوسلا داحتالا ماق ةريخالا نينسلا يف هنا ملعلا عم اذه |	ضعبو يتايفوسلا داحتالا ماق ةريخالا نينسلا يف هنا ملعلا عم اذه
. زعلاو ددؤسلا قيرط اندافحاو انئانبال مسرنو ،ماظعلا انفالسا ه |	. زعلاو ددؤسلا قيرط اندافح او انئانبال مسرز و ،ماظعلا انفالسا
. خلا ةباتکلاو ةءارقلا ملعت نم ًالوقعم ًاردق		      |	. خلا ةباتكلاو ةءارقلا ملعت نم ً الوقعم ًاردق
،زاجحلا يف تنعتملا رجاتلا مهيفو ناكسلا نيب ةدحولا مدع يهو ةين |	ناجحلا يف تنعتملا رجاتلا مهيفو ناكسلا نيب ةدحولا مدع يهو ةينا
،ةرغصم ةروص طوطخ مضي هنکلو ،بيوبتلاو جهنلا يسردم يجزايلا لامک |	،ةرغصم ةروص طوطخ مضي هنكلو ،بيوبتلاو جهنلا يسردم يجزايلا لامك
. ةيليئارسالا دودحلا نم نيبيرقلا ةيوازلاو ةرطينقلا يئاضق ادع  |	. ةيليئارسالا دودحلا نم نيييرقلا ةيوازلاو ةرطينقلا يئاضق ادع
عيضاوم تناكف ىربكلا ةيبرعلا ةرادإلا تالكشم سردب تس ناجل ىلا د |	عيضاوم تناکف ىربكلا ةيبرعلا ةرادإلا تالكشم سردب تس ناجل ىلا د
يذلا لجرلا ةقيقح ىلإ لوصولا يف حجني نأ اهتطساوب كلملل نكمي ةد |	يذلا لجرلا ةقيقح ىلإ لوصولا يف حجني نأ اهتطساوب كلملل نكمي ةد
: يلي ام سمياتلا ةديرج تبتک ةبسانملا هذه يفف . ايناطيرب يف ني |	: يلي ام سمياتلا ةديرج تبتك ةبسانملا هذه يفف . ايناطيرب يف ني
ملعا هللاو نيعلا [ىأر] ىر [هتدهاش] هتهاش ام اذهو ىناديملا دي  |	ملعا هللاو نيعلا [ ىأر] ىر [هتدهاش] هتهاش ام اذهو يناديملا دي
ولو . ةيلبق ةيبصعو ةوسقب زيمتي ناك ىذلا هلالا ،قافآلا قيضلا ي |	ولو . ةيلبق ةيبصعو ةوسقب زيمتي ناک ىذلا هلالا ،قافآلا قيضلا ي
ريبمش ليمك نيحلت ١١/١٢ كبحت كتامح			      |	ريبمش ليمك نيحلت ١١/١٢ ةنايسبجالا كبحت كتامح
. طسوألا قرشلا تاساردو ةيبرعلا تاساردلاب ىنعتو ،توريب	      |	. طسوألا قرشلا تاساردو ةيبرعلا تاساردلاب ىتعتو ،توريب
ةسايسلاب وا خيراتلاب وه امو داصتقالاو ةسايسلاو خيراتلاو ملعلا |	ةسايسلاب وا خيراتلاب وه امو داصتقالاو ةسايسلاو خيراتلاو . ملع
ةنيدم يهو ةينيطرب ةنيدم ىلا يهتنت يتح رهشا ةعبرا ريستف جرخت ا |	ةنيدم يهو ةينيطرب ةنيدم ىلا يهتنت ىتح رهشا ةعبرا ريستف جرخت ا
نودوعي اهتراحبو تيوكلا راجتف . جراخلا يف ةمئادلا هتماقا مهدحا |	نودوعي اهتراجبو تيوكلا راجتف . جراخلا يف ةمئادلا هتماقا مهدحا
يبرعلا ركفلا لغلغتو كارتالا ملسا اذكهو . ًايفاقث مهيلع ترصتنا  |	يبرعلا رکفلا لغلغتو كارتالا ملسا اذكهو . ًايفاقث مهيلع ترصتنا 
. ةيبرعلا تاموكحلا ءاسؤر ىلع ،نانبل يف ةيرصملاو		      |	. ةييرعلا تاموكحلا ءاسؤر ىلع ،نانبل يف ةيرصملاو
ةوهش ايندلا نم يطعا نم لكو . هتبغر ةرخآلا نع تلق همه ايندلا ت |	ةوهشايندلا نم يطعا نم لكو . هتبغر ةرخآلا نع تلق همه ايندلا تن
خارفلاو كمسلاو يلقابلاك اهريخبت رثكي يتلاو نارفعزلاو ةعيملاو  |	خاريفلاو كمسلاو ىلقابلاك اهريخبت رثكي يتلاو نارفعزلاو ةعيملاو
نمً امدقا ةيتايفوسلا ةمصاعلا ىلا لصو دق ،ةلاكولاب عافدلا ريزوو |	نم ً امداقت ةيتايفوسلا ةمصاعلا ىلا لصو دق ،ةلاكولاب عافدلا ريز
نوملسملا ربتعي ملو . ةريبک ةيجيتارتسا ةيمها تاذو ةسدقم ةطقن ي |	نوملسملا ربتعي ملو . ةريبك ةيجيتارتسا ةيمها تاذو ةسدقم ةطقن ي
ةقفاوملا كلت لوصو دنعو ،هيلع ةقفاوملا ماعلا مكاحلل نوناقلا عو |	ةقفاوملا كلك لوصو دنعو ،هيلع ةقفاوملا ماعلا مكاحلل نوناقلا عو
. عامتجالا ملع لوصا یف هقمعت یلا دنتست ةديفم تارابتعاو تاظحال |	. عامتجالا ملع لوصا يف هقمعت ىلا دنتست ةديفم تارابتعاو تاظحال
اهنكمي ال ةيقالخا ةيبقانم ةيرظن ساسالا يف يه ثيح نم اهناو . ي |	اهنكمي ال ةيقالخا ةيبقاثم ةيرظن ساسالا يف يه ثيح نم اهناو . ي
? هشتين لاق امك ،ةوقلا ةدارا ةمدخ يف لمعتسي كينكت ةفرعملا نا  |	? هشنين لاق امك ،ةوقلا ةدارا ةمدخ يف لمعتسي كينكت ةفرعملا نا 
اهدلق جذامن تدغ ام ناعرس لب ،بسحف اهتاذل ةديفم اهباـحصال تابه |	اهدلق جذامن تدغ ام ناعرس لب ،بسحف اهتاذل ةديفم اهرلحصال تابه
ًاقيقتح ةيرودلا تارمتؤملا دقعو ،ةيبرعلا ةعماجلا لود نيب نيرضاح |	ًاقيقحل ةيرودلا تارمتؤملا دقعو ،ةيبرعلا ةعماجلا لود نيب نيرضاح
٣٠١							      |	٣ ٠١
ريرحتلا ةنجل						      |	ريرحنلا ةنبل
ةنسلاك،لحملا تاونس يف ةلاطبلا هذه ةأطو دتشتف ،رطملا ىلع دامتع |	ةنسلاك ،لحملا تاونس يف ةلاطبلا هذه ةأطو دتشتف ،رطملا ىلع دامت
. ةيلاملا اهئابعاب مايقلا نم اهنيكمتل ةلاكولا قودنصل عربتلا ى |	. ةيلاملا اهئابعاب مايفلا نم اهنيكمتل ةلاكولا قودنصل عربتلا ى
ةنيدملا ةالو						      |	ةذيدملا ةالو
الو یرق مهل سيل ءاسلم ءارحص يف لوزن مهو سيقدنبلا یعدت ةيرق ىل |	الو ىرق مهل سيل ءاسلم ءارحص يف لوزن مهو سيقدنبلا ىعدت ةيرق ىل
لوعفم ءاـهتنا نع ءىشانلا عـضولا يف اورظنو نيدلبلا مهت يتلا رو |	لوعفم ءاهتنا نع ءىشانلا عضولا يف اورظنو نيدلبلا مهت يتلا روما
. مامتهالا قحتسي نيئجاللا لجال				      |	. ماتهالا قحتسي نيئجاللا لجال
امذ الا يتجهم يف عدي مل					      |	امف الا يتجهم يف عدي مل
. لوهجم ليصحت ىلإ يدؤي هجو ىلع تامولعملا بيترت ةيفيك نع ثحاب  |	. لوهجم ليصحت ىلإ يدؤي هجو ىلع تامولعملا بيترت ةيفيك نع ثحاب 
ةيقافتالا بجومب ةيقارعلا ةموكحلا ىضاقتتسو . قافتا ىلا قارعلا  |	ةيقافتالا بجومب ةيقارعلا ةمقوكحلا ىضاقتنسو . قافتا ىلا قارعلا
. هعومجمب بعشلا ةحلصم قفو ةيداصتقالا ةايحلا هجوت - ٣	      |	. هعومجمب بعشلا ةحلصم قفو ةيداصتقالا ةايحلا هجوت - ٢٣
ةقيقح نيخرؤملا اوربخي ىتح ىزغملا نوملعي اونوكي مل ةبصنالا هذه |	ةقيقح نيخركوملا اوربخي ىتح ىزغملا نوملعي اونوكي مل ةبصتالا هذ
ديوس بتکو - ٤						      |	ديوس بتكو - ٤
٤٠٠							      |	٤٠٠.
،يسابعلا رصعلا يف ةيبرتلا فادهال زجوملا ضرعلا اذه نم جتنتسن ن |	،يسابعلا رصعلا يف ةيبرتلا فادهال زجوملا ضرعلا اذه نم جتنتسن ن
. ص ١٦٤ . ١٩٦٤ ،ةراضحلا راد ،توريب . ةينثو فوهك		      |	. ص ١٦٤ . ١٩٦٤ ،ةراضحلا راد ،توريب . ةينثو فوهک
ىلا لـیمی میلس قوذ يذ لک نمو دالبلا مدقت يف بغری ةيانع يذ لک  |	ىلا ليمي ميلس قوذ يذ لك نمو دالبلا مدقت يف بغري ةيانع يذ لك ن
ناب داقتعالا ىلا ليمن اننا ريغ . حضاو دحاو ىنعم ىلا اهدر ثحاب |	ناب داقتعالا ىلا ليمن اننا ريغ . حضاو دحاو ىنعم ىلا اهأر ثحاب
- - - - - - - -						      |	-  - -  - - -
. ص ١٠٨							      |	. ص ١٠ ٨
. ٢٨٨/٤ : يراذع نبا ١					      |	. ٢٨٨ /٤ : يراذع نبا ١
،يبلحلا يبابلا يفطصم ،ةرهاقلا . ىلوالا ةعبطلا . مكحلا حرش يف  |	،يبلحلا يبابلا ىفطصم ،ةرهاقلا . ىلوالا ةعبطلا . مكحلا حرش يف 
ريفوتلاو داصتقالاو هيف ةدوجوملا تالوكأملا ةحصو ةفاظن ىلع ةظفا |	ريفوتلاو داصتقالاو هيف ةدوجوملا تالوك أملا ةحصو ةفاظن ىلع ةظف
. اج ،ثنيلک ،سکورب					      |	. اج ،ثنيلك ،سكورب
فرصملا يف ةيدقنلا اهلاوما نم ءزج عادياب اهمازلاوً اقبسا انرشا  |	فرصملا يف ةيدقنلا اهلاوما نم ءزج عادياب اهمازلاوً اقبا انرشا ا
،ًادحاوً ادحوا تاقولخملا هذه نوفشكي اوعرش اهعنص نسحتو رهاجملا ت |	،ًادحاو ً ادحاو تاقولخملا هذه نوفشكي اوعرش اهعنص نسحتو رهاجملا 
اتنالا ربتعي نا هذه ةلاحلاو بجاولا نم ناو ،نادلبلا نم هريغ ال |	ةتنالا ربتعي نا هذه ةلاحلاو بجاولا نم ناو ،نادلبلا نم هريغ ال
. اهلبق نم معدتو ةموکحلا یلا دنتست ،يعامتجالا حالصالل ةريبكلا |	. اهلبق نم معدتو ةموكحلا ىلا دنتست ،يعامتجالا حالصالل ةريبكلا
لخدلا ةلـمج نم ةئاملا يف ٤٢ وحن ضرالل ةيعارزلا تاجتنملا ةميق  |	لخدلا ةلمج نم ةئاملا يف ٤٣ وحن ضرالل ةيعارزلا تاجتنملا ةميق ل
. ةعساو ًاـقافآ انماما حتفي عونلا اذه نم ًايرابتخا اًلمع نا . ةب |	. ةعساوً اقافآ انماما حتفي عونلا اذه نمًايرابتخا اًلمع نا . ةبصخ
. ٤ : ١٦ يناثلا مايالا رابخا يف اهركذ			      |	. ، : ١٦ يناثلا مايالا رابخا يف اهرکذ
لامعالاب مايقلاو ةرادالا ماهم ذخال نييلحملا ناكسلا بيردت ىلا  |	لامعالاب مايقلاو ةرادالا ماهم ذخال نييلحملا ناكسلا بيردت ىلا 
كب يرورس يف ضرتعي كنم روتف ةافاوم نم يطاشن تقو يف كيلع فاخأ ي |	كب يرورس يف ضرتعي كنم روتف ةافاوم نم يطاشن تقو يف كيلع فاخأ ي
١٩٦٢ ةنس ناريزح فورص داؤف : ريرحتلاسيئر ٢ ءزجلا - ١٥ ةنسلا    |	١٩٦٢ ةنس ناريزح نورصواوف . ررحاارسرو ٢ ءزجلا - ١٥ ةنسلا
اياضق يف كلذ نم يهتني ام اريثكو ظافلالاب فرصتلا نسحي يذلا نان |	اياضق يف كلذ نم يهتني ام اريثكو طظافلالاب فرصتلا نسحي يذلا نا
لـبقلا تاـيهشم يناوحقألا اـهرغث اياـنث مـساـبملا رـمح	      |	لبقلا تايهشم يناوحقألا اهرغث ابانث ممابملا رمح
دیعن ناب ،هل لکش ال نایک ىلا وا ،ينیتسرکورب شارف ىلا لوحتت نا |	ديعن ناب ،هل لكش ال نايك ىلا وا ،ینيتسرکورب شارف ىلا لوحتت نا
اـهنوک ثيح نم يا ةقالعلا هذه نم ةدمتسملا كلت ىوس ةقيقح نم اـه |	اهنوك ثيح نم يا ةقالعلا هذه نم ةدمتسملا كلت ىوس ةقيقح نم اهل 
.ً اضاي باتكلل						      |	. ًاضيا باتكلل
يف فلؤملا دامتعا ىلا عجار اذه لعلو ،ً اناياح طبارتلا ضعب اهصقن |	يف فلؤملا دامتعا ىلا عجار اذه لعلو ،ً انايح طبارتلا ضعب اهصقني
ءاضعالا تاجاح اـهبلطتت يتلا ىرخالا ةيعارزلا تامدخلا عـيمجب ما |	ءاضعالا تاجاح اهبلطتت يتلا ىرخالا ةيعارزلا تامدخلا عيمجب مايق
قلطن نا نكمي ام ،يناـنبللا لمعلل يخيراتلا روطتلا يف اهمهاو ،ل |	قلطن نا نكمي ام ،نانبللا لمعلل يخيراتلا روطتلا يف اهمهاو ،لام
یف عارذ / مهتیار / [تناك] و یمعثخلا ةعيبر نب رشب معثخ ةيار ىل |	يف عارذ / مهتيار / [ تناك ] و ىمعثخلا ةعيبر نب رشب معثخ ةيار 
وکسنویلا مقت مل اذاو .ً اضاي كلذل هبـنت نا وكسنویلا بجاو نمف م |	وكسنويلا مقت مل اذاو . ً اضا كلذل هبنت نا وكسنويلا بجاو نمف مه
امو . وحنلاو فرصلا هتفرعمب اـهل ةقث الو ،اهابا قدصت ال ىده نك |	امو . وحنلاو فرصلا هتفرعميب اهل ةقث الو ،اهابا قدصت ال ىده نك
ام ًاريثك مهزايحنا ناف ةفلتخملا ةيعامتجالا تافسلفلا نيب مئاقلا |	ام ًاريثك مهزايحنا ناف ةفلتخملا ةيعامتجالا تافسلفلا نيب مئاقلا
ناتنثا اهنم ابيرقت نوعبرا ةكلمملا ىف ةثيدحلا ةيئادتبالا سرادم |	ناتنثا اهنم ابيرقت نوعبرا ةكلمملا يف ةثيدحلا ةيئادتبالا سرادم
: تلق . هيمدق عضوب يسركلاو شرعلل سامم هنأ هبشألاو ،هألم دق هش |	: تلق . هيمدق عضوب يسركلاو شرعلل سامم هنأ هبشألاو ،هالم دق هش
رخآ دلب ىلا ةعلسلا كلت عنص لقن ام اذاف . ريخلا يف ةدايزف ًانكم |	رخآ دلب ىلا ةعلسلا كلت عنص لقن ام اذاف . ريخلا يف ةدايزفًانكمم
لمعلل تاعامتجا اهنا ساسا ىلع ةمظتنم ةروصب هذهك تاعامتجا ينبت  |	لمعللا تاعامتجا اهنا ساسا ىلع ةمظتنم ةروصب هذهك تاعامتجا ىنبت
،ةدج ،٢ ط ،عـيزوتلاو رشنلل ةيدوعسلا رادلا ،دوعوملا سودرفلا ثی |	،ةدج ،٢ ط ،عيزوتلاو رشنلل ةيدوعسلا رادلا ،دوعوملا سودرفلا ثيد
نم ةيلامشلا قطانملا تناك رشع عباسلا نرقلا ةياـهن يفو . دالبلا |	نم ةيلامشلا قطانملا تناك رشع عباسلا نوقلا ةياهن يفو . دالبلا 
نيخرؤملا صعب دجن یطسولا روصعلا يف ةيهازلا برعلا خيرات ةرتف يف |	نيخرؤملا ضعب دجن ىطسولا روصعلا يف ةيهازلا برعلا خيرات ةرتف يف
وا . اهتدابا ةيفيكو اهتشيعم قرطو تاعورزملاب ةرضملا تارشحلا سر |	وا٠ اهتدابا ةيفيكو اهتشيعم قرطو تاعورزملاب ةرضملا تارشحلا سرد
ةـمزا يه رخآ ىنعمبو ،مويلا ةيطارقميدلا هجاوت يتلا ةديدجلا ةلك |	ةمزا يه رخآ ىنعمو ،مويلا ةيطارقميدلا هجاوت يتلا ةديدجلا ةلكشم
زاجحلا ةرادإ						      |	زاجبا ةرادا
مهريغ دـحال قحي الو . تاوصالا زرفو تيوصتلا تايلمع بقاريو رضحي |	مهريغ دحال قحي الو . تاوصالا زرفو تيوصتلا تايلمع بقاريو رضحي 
نيلثمم دوجو ىلع يوطني مسالا نال انه مسالا اذه اهيلع قلطا نل ي |	نيلثم دوجو ىلع يوطني مسالا نال انه مسالا اذه اهيلع قلطا نل ين
يف ةديحولا ةيضقلاب تسيل لمعلا نع ةلاطبلاو . سمشلا يف امامجتسا |	يف ةديحولا ةيضقلاب تسيل لمعلا نع ةلاطلاو سمشلا يف امامجتسا ،م
اهتمارک عاجرتسا تلواح دقف ًامكحم ًارصح ةيموقلا اـيناملا دودح تر |	اهتمارك عاجرتسا تلواح دقف ًامحكحم ًارصح ةيموقلا ايناملا دودح تر
. تایرحلا هذه نم دحت يتلا				      |	. تايرحلا هذه نم دحت يتلا
ءارزولا تارايس يقئاس نم امبرو ،ناويد ىلا ناوید نم قاروالا نول |	ءارزولا تارايس يقئاس نم امبرو ،ناويد ىلا ناويد نم قاروالا نول
نمو ،مالعإلا لئاسو لالخ نم الإ عساو لکشب نینطاوملا ىلإ لصت نأ |	نمو ،مالعإلا لئاسو لالخ نم الإ عساو لكشب نينطاوملا ىلإ لصت نأ
. يبرعلا قرشلا خيرات تلمش يتلا ةمجرتلاو فيلأتلا ةكرح طشنت نا  |	. يبرعلا قرشلا خيرات تلمش يتلا ةمجرتلاو فيلأتلا ةكرح طشنت نا 
