. سميج . ربرث						      |	* سممح . رسصارت
لكشلا باـصا ديدجتلا اذه نا ملعن نحنو . ديدجتلا نم داقنلا فقوم |	لكشلا باصا ديدجتلا اذه نأ ىلعن ن>و . ديدجتلا نم داقنلا ففقوم 
وهو . دالبلا يف اهنوضقي يتلا ةدملا ةدايزو بناجالا نيحئاسلا دد |	وهو . دالبلا يف ابنوضقي يتلا ةدملا ةدايزو بناحالا نيحثاسلا دد
ضعب يوريو يناثلاو لوالا يسلا ىلا يهتنيف هترابع ةسالسو باذجلا  |	ضعب يوريو يناثلاو لوالا ىسلا ىلا ىهتنف هتوابع ةسالسو يباذملا 
ىلا ايناطيرب نم رفسلل الثم ةماعلا ةحصلا وا بلقلا ةحارج يف نيي |	ىلا امناطيرب نم رفسلل الثم ةماعلا ةحصلا وا بلقلا ةحارح ى نيصا
زاهجلا نع هريرقت يف دراولا ركنس لوب ريسلا يأرً اضاي وه اذهو .  |	زابملا نع هربرقت ىف دراولا ركنس لوي ريسلا يأر أضيا وه اذهو . 
مالا ةبرلا وا تيدورفا مسا اوسانت نكلو تيزلاب هتراجح نوحسميو م |	مالا ةيرلا وأ تيدورفا ممأ اوسانت نكلو تيزلاب هتراحح نوحسميو م
. ةنامورلا ةريظحلا ىلا ةلتحملا				      |	. ةنامورلا ةريظألا ىلا هتحلا
. وفعلا حارتقا لبق ةفرتقملا مئارجلا نع ماعلا		      |	. وذعلا حارتقا لبق ةفرتقملا مثارطا نع مأعلا
دبع بيج لسرا ظفل يفو ىرداوقلا قاذرلا دـبع ديسلا ىلا بسلاو متش |	دنع بيح لسرا ظفل يىفو ىرداوقلا قادرلا لبع ديسلا ىلا بسلاو متش
ىلع ثحبلا كلذ يف امب ةكرتشم ةعفنم تاذ نوكت ةمئاقلا لكاشملا ضع |	ىلع ثحبلا كلذ يف ام ةك رتشم ةعفنم تاذ توكقت ةمئاقلا لك ادْلا ض
. ةرافس ةجرد ىلا نيدلبلا نيب يسامولبدلا ليثمتلا عفر ررقت دقو  |	. ةرافس ةحرد ىلا نيدلبلا نيب يسامولبدلا ليثمتلا مفر ررقت دقو
. اهاوه عبتي						      |	. اهاوه عش
ناجشا . ليصالا حابشا . ةريهظلا جهو . حابصلا ةظقي : نم سبتقم . |	نراخشا . ليصالا حاشا . ةريبظلا جهو . حابصلا ةظقي : نم سدتقم ,
نم صوصنلاو بتكلا هذهل امل ثحبلا اذهل ددحملا رصعلا لالخ ترشن ي |	نمصوصنلاو بتكلا هذهل ال ثحبلا اذهل ددحنا رصعلا لالخ ترشن ىتلا
بعشتم صصختم زاـهج ةطخلا هذه جمارب ذـيفنت ىلع فارشالا .	      |	بعشتم صصختم زاسهج ةطخلا هذه جمارب ذيفنت ىلع فارشالا 
: بساحلا نبا نيحلت نم وهو يسنلبلا قاقزلا نبا رعشو	      |	: بساحلا نبا نيحلت نم وهو ىسنلما ىاقزلا نبا رعشو
نع هـتمتاخو هايملاو ةعارزلا نع لصف هيفو . هلودلل ةيبنجالاو ةي |	نع هنتاخو هايملاو ةعارزلا نع لصف هيفو . هلودلل ةسنحالاو ةيبرع
يحاونلاب نومتهي لئالق نيربخم ىلع دمتعت ةيبرعلا دئارجلا امنيب  |	يحاونلاب _هرو.تم لئالق نيربخم ىلع دمتعت ةيبرعلا دئا را انيب ر
ةمظنالاو نيناوقللً اقوف اهلبق نم اهلامعتسا نكميو ةلماكلا ةيسنر |	ة.ظنالاو نيناوقلل ًاقفو املدق نم اهلاعتسا نكميو ةلماكلا ةسنرفل
ةيلخلا ةدحو بهذم قاثبنا دهاش يذلا ًابيرقت ليجلا سفن يف سوردلا  |	ةءاحلا ةدحو بهذم قاثننا دهاش يذلا ًاسرقت لملا سفن يف سوردلا هذ
الا مهللا - رخآ بعش اهيلا مهقبس املق ةجرد ىلا لصو يذلا نوناقل |	الا مهللا - رخآ بعشس اهيلا مهقبس اماق ةجرد ىلا لصو يذلا نوناق
ودبيو . ًايعوضومً اخرمؤ الً اعفامد ًارشبم ةيميت نبا نع هتباتك يف  |	ودسو . ًاعوضوم أخرؤم ال ًاعفادم ً]رشيم ةيميت نبا نع هتباتك ىف نا
تاضواـفملا يف لوخدلا نم ريغلا عنمي ال هسفن ةصاخ يف ةطخلا هذهب |	تاضوافملا يف لوخدلا نم ريغلا منمي ال هسفن ةصاخ يف ةطخلا هذبب 
ةماقاب حمس دق ةدحتملا ممالا ةمظنم يفً اوعض ةيدوعسلا ةيبرعلا ةك |	ةماقاب ممس دق ةدحتملا ممالا ةمظنم يف ًاوضع ةيدوعسلا ةيبرعلا ةك
ةيبرعلا لودلاو نانويلا يف تمقافت نا تثبل ام نيدرـشملا نيئجالل |	ةسسرعلا لودلاو نانوملا ىف تقافد نا ثّثبل ام نيدرسثملا نيثحاللا
ةيناملرب تاراشتساب ةيروهمجلا سيئر موقي نأب ينانبللا يسايسلا ف |	ةيناملرب تأراشتساب ةيروهمجا سيئر موقي نأب يناتيللا يساسلا فرع
باتكلا راد						      |	ككاشخا5
ةقيرطلاف . مدآ ءانبأك ةريثك هللا ىلا قرط ةيفوصلا لوقي امك كان |	ةقيرطلاف .مدآ ءانبأك ةريثك هللا ىلا قرط ةمفوصلا لوقي اك كانبف
ةركف تناك . ةررحملا ةيبرتلا هنمضتت نا بجي ام يف نيعم دحل ولو  |	ةركف تناك .ةررحغأ ةيبرتلا هنمضتت نأ بحي ام ىف نيعم دط ولو راث
أدبت هرفطلا نانظيو . تانيجلا رغصل هتيؤر نكمي ال تانيجلا ةعيبط |	أدت هرفطلا نا نظيو . تانيطا رّكصا هتيؤر نكسمي ال تانيملا ةءيط 
: ةيسايسلاو ةيعامتجالا فورظلا ببسب ةعئاضلا ةيرشبلا دراوملا :ً  |	: ةمسامسلاو ةيعاتحالا فورظلا بيس ةعئاضلا ةيرشلا دراوملا : ًاعب
. قارعلا كلم ينانلا لصيف كلملا				      |	٠. فقارعلا كلم ىنالأ لصيف كلملا
. يرئازجلا يعويشلا بزحلا لحب الليب نب دمحا يرئازجلا سيئرلا رم |	. يرئازجلا يعويشلا بزكلا لحب اللس نب دمحا يرئازجلا سيئرلا رمأ
. تاليهستلاو ينابملا متت املاح				      |	. تاليبستلاو يفابملا متت املاح
. ةيعقاو فادهألا نوكت نأ يغبني -			      |	.ةيعقاو فادهألا نوكت نأ يغبني -
روحالا لازغلاك ينانج يروح رمسالا بيضقلاك ىنثت رمسأ	      |	روحالا لازغلاك ىنانج ىروح  ٌرمسالا بيضقلاك ىنثت رمسأ
رايتخالا قح اهبجومب حنم يتلا ىرخالا تاطلسلا عـيمجل هتسرامم دن |	رايتخالا قح اهبحومم حنم يلا ىرخالا تاطلسلا عيمب هتسرام دنع هر
نا ينانبللا يعانصلا دادعتلا نع ريراقتلا أرقي نمل رهظيو . ةيعا |	كرأ ىفاتيللا ىعانصلا دادعتلا نع. ريراقتلا أرقب نأ ربظبو . ةيع
يسآم نم ةيناث ةاسأم ىلع راتسلا لدسا ةنسلا كلت يف - انخيرات يف |	ىمام نم ةيناث ةاسأم ىلع راتسلا لدسا ةئسلا كلت ىف - انكراتىف ة
هل عضخي ًاـتباثً امانظ ملاعلا يف ناب يعيبطلا نوناقلاب نونمؤملا  |	( عض#ل ]تباث ًاماظن ملاعلا يف ناب يعببطلا نوناقلاب نوئمؤملا لا
ثاحبألا							      |	تاحلا
تاداقتنا دض هدعاسو هججحو يبلكلا نبا ءارآ نم ربكالا مسقلا تبثأ |	تاداقتنا دض هدعاسو هججحو ىلكلا نبا ءارا نم ربكالا مسقلا تبثأ 
توريب يف ةيكريمألا ةعماجلا اـهردصت ةلجم			      |	توّربإ لكدمألا فماجبا ايحررضنرب
. مامالأ ىلا ةيندملا عفدي نأو ةننوكلاو نوكلا قيرط	      |	. مامالا ىلا ةيندملا عفدي نأو ةننوكللاو نوككلا قيرط
. اذه ضيقن ىلع رمالا لب فلحلا وا			      |	. اذه ضمقن ىلع رمالا لب فللا وا
. بيجن دمحم ماعلا دئاقلاو يكريمالا ريفسلاو اشاب رهام يلع سيئر |	. بيجن دمس ماعلا دئاقلاو جريمالا ريفسلاو اًساب رهام ىلع سيئرلا
ىأر نم لواو . رطفلا روذبو ةريمخلا ايالخ اوأرو ةملاسملاو ةراضل |	ىأر نم لوأو . رطفلا روذبو ةريجلا ابالخ اوأرو ةملاسملاو ةراضلا
: ةيلاتلا ماكحالا نم ودبي امك ةيمكلا ثيح نم فيلستلا ديدحت :ً ا |	: ةيلاثلا ماكحالا نم ودبي )م ةيمكلا ثيح نم فيلستلا ديدحت : آل
. نيعم يـنس ميعزو ةيروهمجلا سيئر نيب أشنت يتلا ةديطولا تاقالع |	. نّبعم يّنس معزو ةيروهما سيئر نيب أشنت يتلا ةديطولا تاقالعلا د
ةسايسلل مت اذا هناف اذهلو . ةراسخب انايحا اهعيبو جراخلا ىلا م |	ةسايسل[ مث اذا هناف اذهو .ةراسخانامحا اهعيبو جراخلا ىلا مهعئا
عمتجملا لجا نم لمعلا ىلع ءاضعالا بردتف اهلامعا ذيفنت يف ةيبزح |	عيضلا لجا نم لمعلا ىلع ءاضعالا بردتف اهلاءءا ديفنت يف ةيبرالا
يبرـعلايملـعلا ركـفلا روطت				      |	يرسلايلاايلار وطت
. دالبلا						      |	, هالأا
. نامع يف يناطيربلا لخدتلا دض ةدحتملا ممالا ىلا ًاجاجتحا ةيقير |	. نا.ء يف يناطي ريلا لخدتلا دض ةدحاملا مهالا ىلا ًاحاحتحا ةيقي
ءابنالا تالاكو تماقو . ةلوهسب هعفدت نا ةديرجلا عسوب ًالوقعم ًاك |	ءابنالا تالكو تماقو .ةلوهسسب هعفدت نا ةديرجلا عسوب ًالوقعم أك 
. ةيرشبلا اهاوقل طيطختلا ىلع ةسسؤملا			      |	. ةيرشسبلا اهاوقل طيطختلا ىلع ةسسؤملا
. لخدلا ىوتسم طوبه متحتيف فيظوتلاو			      |	. لخدلا .ىوتسم طوبه ممحتبف فيظوتلاو
نويع ناهرلا موي اهب تقلع اـهنا ال اـهقبس ةعاسب تفرع	      |	اكوبع تاهرلا::موي اب تقلع ابيهنا ال اهقبس ةعاسن ِتفرع
تضق ثيحب ينامورلا مالسلا بابشلا دهع يف ةيريشبتلا برحلا تطشن د |	تضق ثدحيلام ورلا مالسلا باشلا دهعيف ةيريشدتلا ب رخا تطشن دقف.
لب ًاـعبارم سيل هناف لوصحملا نم هتصخ ذـخأي ناك ناو عرازملا نا  |	لب ًاعبارم سل هناف لوصحملا نم هتصخ ذخأي ناك ناو عرازملا نا ا .
. عمتجملا ةحلصم عم وا نيرخآلا قوقح عم ضراعتت ال تماد ام اهدكؤ |	. عمتجملا ةحلصم عم وأ نيرخآلا قوقح عم ضراعتت ال تماد ام اهدئو
يفو ريصملا ريرقت يف نيينادوسلا قحبً اديوط ًاناميا ةيرصملا ةموكح |	ىفوريصملا ريرقت ىف ثيينادوسلا قحي ًاديطو ًاناعا ةيرصملا ةموكملا
هبولساو . حالصالا لجا نم ةقداص ةينطو ةبغرب هتجلاعم يف عوفدم ف |	ةيولساو . حالصالا لجأ نم ةقداص ةينطو ةيغرب هتحلاعم يف عوفدم ف
لاملا مئارج وا لجرلا نيا				      |	لاخلا تارج وأ لجرلا نا
نانبل - توريب						      |	نانتل - توزريتب 
نم لئاسلا ركسلل لمعمو ةيعارز تاعانصو ديدحلل رخآو قرولا لمعمو  |	عم لئاسلا ركسسلل لمعمو ةععارز تاعانضو ديدحال رخنآو قرولا لمعف
لمحتتل ةيعيرشتلا سلاجملا هذه ةيوقت مويلا ةيطارقميدلا تابجاو م |	لئختتل ةيعيرشتلا سلاجملا هذه ةنوقت مويلا ةيطارقيدلا تابجاو مه
ةدحتملا ممالا اهب تصوا يتلا فيراعتلا عم قفتت لوالا ريرقتلل ةم |	ةدحتملا مهالا ا,تصوأ ىبلا فيراعتلا عم قفتت لوالا ريرقتلل ةمدق
تاريخلا هذه ىلع اولصحيل مهعسو يف اـم لك اولمعي نا مهبولق يف ا |	تاريكبا هذه ىلع اواصخبل ميعسو يف ام لك اواءعي نا مهبواق يف او
وا ةلادعلا ققحيل نكي مل ماظنك وهو . سسالا هذه هل اـملاط كلذ س |	وأ ةلادعلا ققحيل نكي مل ماظنك وهو . سسالا هذه هلا_ ح لاط كلذ 
ررحم يتيام نم برقي ام ةيكريمالا دئارجلا ضعب ريرحت مسق يف تدها |	ررحم ىتبام نم برقي ام ةيك ريمالا دئارطا ضعب ريرحت مسق ىف تدها
. تانب ثالثو						      |	. تانش ثاللثو
ةربخلا لها مامتها ريثي نأب ريدج نابانكلا اهاوتحا يتلا ةداملا  |	ةريكلا لها ماتها ريث تأب ردح تاباتكلا اهاوتحا ْقلا ةدالا نم-رب
ةيميظنتلا ةطلسلا					      |	ةمظتتلا ةطلسلا
اـمبر وا انب بهشلا تراغ					      |	امير ىا انب ببشلا .تراغ
ًاحاحلإ دشا ليماسرلا ىلا ةجاحلا تحبصا نيئجاللا ليس قفدتبو . اه |	احالإ دسا ليماسرلاىلا ةجاطلا تحصا نيثحاللا لهسؤةدتيو .اهناكتس
ريبكلا جاتنالا نمضتي ينفلا ءامنالا نا ريغ . ةدحتملا تايالولاو |	ريبكلا جاتنالا نمضتي ينفلا ءانالا نأ ريغ.ةدحتملا تالايولاو اب
لصح وا ةباتكلا ءانثا أطخلا نم ءيش ديلولا ةملك ىلع أرط - أ : ت |	لصح وا ةياتكلا ءانثا أطخلا نم ءىش دملولا ةملك ىلع أرط -أ : تا
ةغللا لخدت يتلا ةديدجلا يناعملا نا ظحالن ةيناث ةهج نمو	      |	ةغللا لخدت ىتلا ةديدجلا يناعملا نا ظحالن ةيناث ةبج نمو
. اـهيلع ءاقبالا نم نالا ىتح اشاب مازع			      |	. اهملع ءاقبالا نم نالا ىتح اساب مازع
عورشملا ةمدقم يف نيئجاللا ةـثاغا ةئيهل ماعلا ريدملا رفراك يلس |	عورشملا ةمدقم يف نيئِجاللا ةئاغأ ةئيهل ماعلا ريدملا رفراك ىلسل
. ةنيعم دودح اهل قطانم نع نيلوؤسم نييرادا		      |	.ةنمم دودح امل قطانم نع نياوؤسنيدرادا
ىلا طيحملا نم قيرط وه اهنم عاعش لكو . قرطلا ىلا زمرتف هعشالا  |	ىلا طيمملا نم قيرط وه ابنم عاعُش لكو .قرطلا ىلا زمرتف هعشالا ا
. ةغللا صخت تاحلطصمو - ىنعملا نم - ةيونعم تاحلطصم نيب	      |	. ةغللا صخت تاحلطصمو  ىنعملا نم  ةيونعم تاحلطصم نيب
تاعورشملاا هذه ذيفنت متي فيك . . وه لاجملا اذه يف هتراثا نم د |	تاعورسملا هذه ذيفنت متي فيك ..وه لاجملا اذهيف هتراثا نم دب ال
. يناليكلا ءايمل ةسنالل روصعلا مدقا ذنم طسوالا قرشلا	      |	. يناليكلا ءامل ةسنالل روصعلا مدقا ذنم طسوالا قرشلا
مجن فسوي دمحم						      |	مجت فسون دمح
ةعوطقم ةروصب مزاوللا هذه ردقت . تاعطقلل ةيداعلا تاصصخملا نع ة |	ةعوطقم ةروصب مزاوللا هذه ردقت . تاغطقلل ةيداعلا تاصصخما نع ةد
اـهيمسي ةيبرتلا نم ًاعون يسابعلا رصعلا يف كانه نا ىري اًلثم يتح |	اهيمس ةيبرتلا نم ًاعون ىسايعلا رصعلا يف كانه نا ىري الثم ّىح رو
ةعيبطلا رعش						      |	ةعماطلا رعش
. ةماركلاو قحلا عالق نم ةخسار ةعلق			      |	. ةماركلاو ىلا عالق نم ةخسار ةعلق
. ةرقنا يف ضوفملا ندرالا ريزوو ناتسكابلا		      |	. ةارقثا يف ضوفملا ثدراإلا رزوو تاتسك املإ
ىلا برقا دهعلا كلذ فرع يف وهف . اهعرزي يتلا ضرالا نم ًاءزج تقو |	ىلا برقا دبعلا كلذ فرع يف وبف . ابعرزب ىتلا ضرالا نم ًاءزج:تقو
. هيف مهكامسأ نوعيبي رخآ عضوم ىلا نورجهيو كامسألا	      |	. هيف مهك امسأ نوعيبي رخآ عضوم ىلا نورجبيو كامسألا
وكسوم يف ةدحتملا ةيبرعلا ةيروهمجلا ةرافس نع ردص نايب يف ملاس  |	وكسوهيف ةدحتملا ةيبرعلا ةيرويمحا ةرافس نع ردص تايبيف ملاس حال
يقالخالا رايتلا بايسنا وه يناثلا فرطلاو سلدنالا بدأ نع عافدلا |	يقالخالا رايثلا بايسنا وه يناثلا فرطلاو سادناألا بدأ نع عافدل
ال نيذلا ليجانالاو ةاروتلا ءاملع ددع نوكي نا ىشخاو . ةىيخيرات |	ال نيذلا لمحانالاو ةاروتلا ءامع ددع نوكي نا ىشخاو . ةمخراتلا 
راطخا ءردو نزخلاو فيرصتلاو يرلا عيراشم نع ًادج ةرصتخمب ةرظن هذ |	راطخا ءردو نزّآلاو فيرصتلاو يرلا عيراشم نع ًادج ةرصتخم ةرظن هذه
دوجو ىلع ةمزاج ةروصب لدت اـهيف ةيباينلاو ةيدلبلا تاباختنالا ر |	دوجو ىلع ةمزاج ةروصب لدق ا بمف ةيباسشلاو ةيدلبلا تاباختنالا ر
. مهلكاشملو ةيعامتجالا ةمدخلا لقح يف لامعلل اهسفن سركتو	      |	٠ مهاك اشملو ةيعاتجالا ةمدخلا لقح يف لاعلل اهسفن سركتو
امدنعو خلا . . بيبطو مكاحو يرادا فظوم اهلو ةرادا سلجمو يدلب س |	امدنعو خلا .. بيبطو 1 احو يرادا فظوم املو ةرادا سلجمو ىدلب سل
ليجلا يف ةركاب ةيلمع يه ةبورعلا ءاحنا عـيمج ىلع تادرفملا ةمئا |	ليجلايفةركاب ةيلمع يه ةيورعلا ءاحنأ ميمج ىلع تادرفملا ةّاق ممع
تدقعت عمتجم يف ةيعامتجا ةايح اوشيعي نال دارفالا دادعا اـهنم ض |	تدقعت عمتجم يف ةيعاّتجا ةايح اوثيعي نال دأرفالا دادعا اهنم ضرغ
. ةـيعامج تاقافتا قيرط نع رحلا ملاعلا راطقا نيب ةراجتلا عيسوت |	. ةيعاج تاقافتا قيرط نع رخلا ملاعلا راطقأ نيب ةراجتلا عيسوت ى
. نانبل يف ًايبسن بلغت ةيراجتلا ةفصلا نا ولو نايراجت نادلب اير |	. نانمل يف ًاسسن فبلغت ةءراحتلا ةفصلا نا ولو نارراُت نادلب ابرو
ةريثكلا مولعلا نم دادمتسا هلو لدجلا ملع نم ةطبنتسم هئدابمو .  |	ةريثكلا مولعلا نم دادمتسا هلو لدحلا ملع نم ةطبنتسم هئدابمو .ه
ةكرتشملا تاسلجلا					      |	ة* رثشملا تاساملا
. مهدماحم الملا يف ًارشانو				      |	. مهدما# الملا يف ًارشائو
لوالا هدع دقف . توقايو يدوعسملا مهزربا نم ءايوقا ءارصن يبلكلا |	لوالا.دع دقف .٠ توقايو يدوعبسملا مززبا ن.ه ءايوقا ءارسعن ىلكل
اولحف ةئيسلا لاحلا كلتب انودجوف انيلا موقلا لبقاف انتلمحي انح |	اولحف ةئيسلا لاحلا كلتب انودحوف انملا موقلالمقاف انتلمح انحصق
ريـنلا تحت تعقو يتلا نادلبلا هذه يف راج وه امب ربتعي ال نمو . |	رينلا تحت تعقو ينلا نادلبلا هذه يف ٍراج وه ام ربتعي ال نمو . د
اـهنكلو ! قيش لهس سرد نم هل اي ! ةينفلا هنازيمو يلهاجلا رعشلا |	ابنكلو ! ىتش لهس سرد نم هلاي ! ةينفلا هتازيمو ىلهالا رعشلا ضا
يف لب نيطسلف ىلا مهتدوع يف نوكي ال مهصالخو . ساـنلا ىلع هورشن |	يف لب نيطسلف ىلآ مهتدوع يف ثوعكي ال مهصالخو . ساالا ىلع هورشن
نطاوملا ىتح همعدي مل اذا ًاقالطا حالصإلا اذـه يرجي ال دقو . سا |	نطاوملا ّيح همدي مل اذا ًاقالطا حالصإلا اذه يرحي ال دقو . سانلا
. رمالا اذهب ةينعملا نادلبلا عميج ةراشتسا كلذ ولتي نا يغبني ه |	.رمالا اذبب ةينمملا نادلبلا ميج ةراشتسا كلذ ولتي نا يثبني هنأ
. اهتينازيم						      |	. اهتينازلم
ةليسو ريخو . ةكرتشملا ةيئاشنالاو ةيعينصتلا جماربلا ذيفنتو عضو |	ةلمسو ريخو . ةكرتشملا ةيئاشناللو ةيعينصتلا جماربلا ذيفنتو عضو
. انرظن ةهجو معدي ام ابوروا يفو ةيكريمالا		      |	. انرظن ةبحو معدي ام ابوروا ٍو ةيك ريمالا
ةمزاللا قوسلا نامضو ةيلحملا دراوملا ىلا تاعانصلا هذه دانتسا م |	ةمزاللا قوسلا ناضو ةيلحملا دراوملاىلا تاعانصلا هذه دانتسا موز
معدب ةيئاضقلا تائيهلا هذه تعتمت دقو . اهدهعتو دارفالل ةعورشمل |	معدب ةيئاضقلا تائمهلا هذه تعتم دقو . اهدبعتو دارفالل ةعورشملا
. ةرادالا فرصت تحت يتلا ةيجاتنالا			      |	. ةرادالا فرصت تحن ىنلا ةيحاتنالا
براجت هيلا تهتنا امبسح فيرلا ةمدخل نيئيهمو ادادعا نيدعم اصاخش |	براجت هيلا تيتنا امسح فيرلا ةمدخل نيئيبمو ادادعا ندعم اصاخشا
عئاقولا لسلستو ثدحلا ىلع دمتعت يتلا ةيمحلملا لامعألا يف هدهشن |	عئاقولا لسلستو ثدحلا ىلع دمتعت يىلا ةيمحلملا لامعألا ين هدهشن
ةلود يا ءازا يناودع لمع ياب مايقلا مزتعت ال ةيرتشملا ةلودلا ن |	ةلود يا ءازا يلاودع لمع ياب مايقلا مزتعت.ال ةيرتشملا ةلودلا ن
ةرواجملا ممالا نع مالكلا ىلا اهنزواجتي دقو ةيبرعلا دالبلا راب |	ةرواجما ممالا نع مالكلا ىلا اهنوزواجتي دقو ةيبرعلا دالبلا راب
ةرمغ يف اهفالتخا ىلع مهراثآ ترمطناف دمألا ليوط مظنم داهطضال ا |	ةرمغ يف اهفالتخا ىلع مهراثا ترمطناف دمألا ليوط مظنم داهطضال ا
نا وه ةـحنجالاو شارفلا نيب قرفلا نكل . ةرئاطلا ةحنجا عطقم هبا |	تمأ وه ةحجالاو شارفلا نيب قرفلا نكلل . ةرئللا ةمتجا مطقم هباش
خيراتلا مهفت ىلع امئاق ًافطع اهتيضقو ةأرملا ىلع ًافطع ءالتما دق |	نيراتلا مهفت ىلع .امثاق افطع !متيضقو ةأرملا ىلع أفطع ءالتما د
؛ ةلودلا ةدايس ةيرظن : ةيسيئر مئاعد ثالث ىلع يبرغلا ةلودلا ما |	؛ ةلودلا ةدايس ةيرظن : ةيسيئر متاعد ثالث ىلع يبرغلا ةلودلا ما
بيهصل هللا رفغ - ١					      |	بسصل هللا رفغ -١
نورشعلاو ةسماخلا ةداملا					      |	نورشعلاو ةسماخلا ةداملأ
نيتئام ىلاوح ةدوع ىلع تقفاو ليئارسا نا سدقلا يف ةندهلا ةبقارم |	نينثام ىلاوح ةدوعلع تقفاو لمئارسا نا سدقلا يف ةندحلا ةيقارم ة
ىلع وا - ةيملاعلا حمقلا ةراجت يف ًاماه ًازكرم ايروسل نا ةلهو لو |	ىلع وا - ةيملاعلا حيمقلا ةراحت يف أماه ًازكرم ايروسل نأ ةلهو ل
. ةينيلرتسا ةريل فلا نيثالث				      |	. ةينلريسأ ةريأ فلا نيثالث
ةيرامعتسالا رشع عساتلا نرقلا ةسايس قيبطت يف رارمتسالا يلا ةـي |	ةررامعتسالا رشع عساتلا نرقلا ةسايس قيبطت يف رارمتسالا يىلا ةب
أدب دق ناك هاجتالا اذه نا يف كش الو . ركفلاو لقعلا ةيمنتو كول |	ًادب دق نراك هاجتالا اذه نا يف كش الو . ركفلاو :لقعلا ةسسئتو ك
: ةريخالا تاونسلا					      |	: ةريشالا تاوئسلا
عومجم يف ًادج ةريبك ةيمها اهل نوكي دق هذهو نانبل يف لامع ةثالث |	عومج . يف ًادح ةريبك ةيمها ال نركي دق هذهو نانيل. ىف.لاع ةثالث
ناـطلسلا ةوق تأدب امدنع ةيبرعلا دالبلا يف ةيكلملا ماظن يف يلع |	ناطلسلا ةوق تأدب امدنع ةيبرعلا دالبلا يف ةبكلملا ماظن يف ىلعف
هيلا راشملا باتكلا يف امهتبثاو نأشلا اذه يف يارغ امهارجا رابت |	)نلا راشملا باتكلا ىف اهتيثاو نأشلا اذه يف يارغ اهارجا رامتخا
كلذكو . نيينعملا ضارقنا دعب نييباهشلا ىلا ةرامالاب دهع ةيناقم |	كلذك و .نيينعملا ٍضارقنا دعي نيساهشلاىلا ةرامالاب دبع ةناقمسلا
كلاذب نوكي هنأل ءيش هل نكي مل ناقح امهن : لاقوً اعيجم نادهاشلا |	كاذب نوكي هنآل ءيش هل نكي مل ناقح امهنا : لاقو ًاعيمج نادهاشلا
اـيندلا وطخت نا تعطتسا ناف نوقابلا قرغيسو نوضاملا اهيف قرغ دق |	ايندلا وطخت نأ تعطتسا ناف ثوقاملا قرغيسو نوضاملا اهمف قرغ دق 
. نيساسب صمقت دوقرم وه : سيدقلا اذه رما نم ينرماخي ام كل تلق  |	.نيساسب صمقت دوقرم وه: سيدقلااذه ىما نميفرما ام كل تلق اذا رف
. نيماقملا نيب سبحلا : ةفقولا				      |	. نيماقملا نيب سسحلا : ةفقولا
ةـقطنملا ريخ هيف امل ةدافتسالا دودح ىصقا ىلاو ةيئاملا دراوملا |	ةةطاملا ريخ هنف اامل ةدافتسالا دودح ىصقا ىلآو ةيئاملا دراوملا
ناـجللا لمعتو تاعامتجالا دقعتو تارضاحملا اهيف ىقلتو اليوط هذه |	ناجللا ليعتو تاءاتجالا دقعتو تارضاحملا اهيف ىقلتو اليوط هذه م
يتلا تالقنتلا ةرثك هيلا تدا يذلا صصختلا مدع نع ًاجتان تارازولا |	يتلا تالقنتلا ةرثك هيلا تدا يزلأ صصختلا مدع نع أمّتان تارازولا
. سانلا ريهامج لوانتم يف نوكي اًلقن ةفاقثلا لقنت يتلا ةديحولا  |	. سانلا ريهامج لوانتم يف نوكي اّلقن ةفاقثلا لقنت يثلا ةديحولا 
. نوعمش ليمك سيئرلا					      |	٠. نوعمش ليمك سيرلا
. ملاعلا قطانم						      |	. ملاعلا قطاذم
دعب ةنس ةدحتملا ممالا ةئيه ىنبتت نا ريكفتلاو ةشهدلا ىلا وعدت  |	دعب ةنس ةدحتملا ممالا ةّئيه ىنبتت نرا ريكفتلاو ةشهدلا ىلا وعدت
بتك اـهنيبو بتكلا نومجرتي هذيمالتو ةعافر ذخاو يواطهطلا ةعافر  |	بتك ابذيو بتكلا نومجرتي هذيمالتو ةعافر ذخأو يواطبطلا ةعافر دو
: يلي امب ةتقوملا ةيذيفنتلا ةطلسلا فلكتيس - ش		      |	: ىلي امب ةتقوملا ةيذمفنتلا ةطلسلا فلكتيس -- ش
وا مهسفنا ةـنجللا وفظوم اهب ماق يتلا ةروشنملا تاساردلاو ثوحبل |	وأ مهسفنا ةنحللا وفظوم اهب ماق ىتلا ةروشنملا تاساردلاو ثوحبلا
. ايروس يف ةذفانلا					      |	. ايروس ىف ةدفانلا
ةخسن اهنأ ىلع ةطوطخملا كلت نم هباتك يف اهجردأ يتلا جذامنلا لد |	ةخسن اهنأ ىلع ةطوطخملا كلت نم هباتك يف اهجردأ ىتلا جذامنلا لد
ساـنلل مجارت ىلع يوتحي رخآ مسق يرمعلا باتك نم يفارغجلا مسقلا  |	سانال مجارت ىلع يوتحي رخا مسق يرمعلا باتك نم يفا رغجلا مسقلا 
١١/١ ةنايسبجالا دمحا ما					      |	1١/١  ةلايسبجالا 03---- دمحا م
ًالدعا ًاقحمً افيرتص اهفرصي نا نيفظوملا ناويد عـيطتسي يتلا قوقحل |	الداع أقع ًافيرصت اهفرصي نا نيفظوملا ناويد عيطتسي يتلا قوقللا 
ًاينف اًليلمع اًلكش ةساردلا ذختت ةقيرطلا هذهبف . ةيسردم ةرشن راد |	ًاينف اليلمع الكش ةساردلا ذخيتت ةقيرطلا هذببف . ةيسردم ةرشن را
هردص حتف يقيدص نا وه هلجال ىلوملا تركشو ًاريثك ينع ففخ يذلا نك |	هردص ميتف يقيدص نأ وه هلجال ىلوملا تركشو ًاريثك ىنع ففخ يذلا ن
ًابئان يلكشيشلا بيدا ديقعلا ةيمستب رخآ موسرم ردصو ءارزولا سلجم |	ايئان ىلكشيشلا بيدا ديقعلا ةيمستب رتآ موسرم ردصو ءارزولا سلجم
. دالبلا ءاحنا فلتخم يف ىرخا ةينارمع			      |	. دالبلا ءاهأ فلتع يف ىرخا ةنارمحج
. يفاقتلا صلجملا - ج . يداصتقالا سلجملا - ب . عافدلا سلجم - ا |	. يفاقتلا صاخمللا-ج . يمداصتقالا سلجحلا -ب  . عافدلا سلي ١
. يرطيبلا						      |	. ىرطسلا
الو . ىحصفلا زيكرتل ةدينع ةلواحم عم ةيبعشلا مهافتلا تاجهل     |	الو . ىحصفلا زيك رتل ةدينع ةلواحم معم ةيبعشلا مهافتلا تاحم
. مويلا اذه خيراتب دوقعملا ةيفصتلا قافتا يف لخدي مل يذلا ءزجل |	. موبلا-اذه خيراتب دوقعملا ةيفصتلا قافتا يف لخدي مل يذلا ءزحل
. ةديدجلا ثادحالا هاجت لئاسولا دادعال ةصرف ةموكحلا طعي مل ريص |	. ةديدهلا ثادحالا هاحن لئاسولا دادعال ةصرف ةموكتلا طعي ملديصق
يتلا ةيرادإلا ةئيبلاب متهت نأ بجي ةيرادإلا ةفرعملاف . يرادإلا |	ىتلا ةيرادإلا ةئيبلاب متبت نأ بجي ةيرادإلا ةفرعملاف . يرادإلا
ةيمألا ةحفاكم ةلمح					      |	ةممألا ةحفاكم ةلمح
ةعقر عاستا نم مغرلاب ذا .ً اضاي قارعلا قطانم ضعب ىلع هسفن ءيشل |	ةعقر عاستا نم مغرلاب ذا . أضيأ قارعلا قطانم ضعب ىلع هسفن ءىشل
سرادم لعج يذلا ببسلاو . سرادملا هذه ةرايزل رطق لك نم نودفاوتي |	سرادم لعج يذلا ببسلاو . سرادملا هذه ةرايزا رطق لك نم نودفاوتي
لاحرل رفغا مهللا - ١					      |	لاحرل رفعا مهللا -١
. يركسعلا يكريمالا لخدتلل ةجيتن نانبل يف نييلودلا نيبقارملا ل |	. يركيسلا ىرسمالا لخدتا ةحيتن ثانيل يف نييلودلا نيبقارملا لام
يف زيزعلا دبع ورتايتب هحرسم ىلع ةمجرتلا هذهب ةيحرسملا هذه لثم |	يف زيزعلا دبع ورتايتب هحرسم ىلع ةمجرتلا هذبب ةيحرسملا هذه لثم
اـصرفلا هنم راهزاللا بهنت				      |	ابصرفلا هنم . راهزإلا ببثتت
برحلا تائيس مهلمحت دعب مالسلا تاريخ ىلا نونحي اوذخا نيذلا ىرخ |	نركلا تائيس مهاسحن دعب مالسلا تاريخىلانونجي اوذخا نيذلا ىرخال
نيينادوسلل اهلالخ ةدايسلا				      |	نينادوسال اهالخ ةداسلا
نررالا تناكو . ةيليئارسالا يضارالا ىلا نيراحسلا ةليبق نم لحرل |	نررالا تناكو . ةيليئارسالا يضارالا ىلا نيراحسلا ةلبق نه لحرلا
. ررضلا هقحل يذلا صخشلل ةبه اهمدقت ةفلاتلا ةعاضبلا وا ةقراغلا |	,ررضلا هقُح يذلا صخشلل ةبه اهمدقت ةفلاتلا ةعاضبلا وا ةقرافلا ة
ةدحتملا ةيبرعلا ةيروهمجلا ةموكح ىلا تبلط اهنا ةيقارعلا ةيجراخ |	ةدجتما ,ةيب رعلا ةيروبمحا ةموكح ىلا تيلط امنا ةيقارعلا ةيحراخ
ةيكاطنا ىلا ةجنرف كلم نم مهعم ام عيمجو ةدوعلاو كسملا نوعيبيف  |	ةيكاطنا ىلا ةثرف كلم نم مبعم اه عيمجو ةدوعلاو كسملا نوعيبيف ا
ضعبو ييايفوسلا داحتالا ماق ةريخالا نينسلا يف هنا ملعلا عم اذه |	ضعبو يقايفوسلا داحتالا ماق ةريخالا نينسلا يف هنأ ملعلا عم اذه
مهلمع يف مهدعاسي خويش ديب مومعلا هجوب ةيفيرلا قطانملا ةرادا ت |	مهلع يف ثدعاسي خويش ديب مو.علا هجوب ةيفيرلا قطانملا ةرادا تنا
. ةيليئارسالا دودحلا نم نيبيرقلا ةيوازلاو ةرطينقلا يئاضق ادع  |	. ةيليئارسالا دودخلا نم نيسرقلا ةوازلاو ةرطبنقلا يناضق ادع
راثآلاو نامثلا تاقبطلاب ةينبالا فصو عقوملا اذه رايتخا ىلا تدح |	راثآلاو نائلا تاقمطلاب ةينبالا فصو عقوملا اذه رايتخا ىلا تدح 
عيضاوم تناكف ىربكلا ةيبرعلا ةرادإلا تالكشم سردب تس ناجل ىلا د |	عيضأ وم: تناهكف ىريكلا ةيبرعلا ةرادإلا تالكشم سردب'تس ناجل ىل
: ةرامحلا نبا نيحلت نم روهشملا رعشلاو			      |	: ةرامحا نبا نيحلت نم رووشملا رعشلاو
يذلا لجرلا ةقيقح ىلإ لوصولا يف حجني نأ اهتطساوب كلملل نكمي ةد |	ىذلا لجرلا ةقيقح ىلإ لوصولا ىف حجني نأ اهتطساوب كلملل نكمي ةد
نمم مهريغ [الو ....] نبا الو يدوج نبا الو ةرامحلا نبا الو ةجا |	نمم مهريغ | الو .... | نباالو يدوج نباالو ةرامحلا نباالو ةجاب
ملعا هللاو نيعلا [ىأر] ىر [هتدهاش] هتهاش ام اذهو ىناديملا دي  |	لعا هللاو نيعلا ] ىأر [ ىر | هتدهاش [ هتهاش ام اذهو ىنادمملا 
. ةيبنجا						      |	. ةيسنجإ'
ةسايسلاب وا خيراتلاب وه امو داصتقالاو ةسايسلاو خيراتلاو ملعلا |	ةسايسلاب وا خيراتلاب وه امو داصتقالاو ةسايسلاو خيراتلاو .ملعل
. امهنيب						      |	+ امهنيب
ةنيدم يهو ةينيطرب ةنيدم ىلا يهتنت يتح رهشا ةعبرا ريستف جرخت ا |	ةنيدم يهو ةشطرب ةنيدم ىلا يبتنت ىح ربشا ةعبرا ريستف جرخت اهلم
نودوعي اهتراحبو تيوكلا راجتف . جراخلا يف ةمئادلا هتماقا مهدحا |	تودوعي امراحمو تيوكلا رادتف .جراخلا يف ةئادلا هتماقا هدحا ْذْخَت
نع برعلا اهثرو دـيلاقتو تاداعب زيمتت اذه بناج ىلا ةيبرعلا ةاي |	نع برعلا اهئرو دلاقتو تاداعي زيمتت. !ذه سناج ىلا ةيبرعلا ةايل
ريرحتلا سيئر						      |	ربرحتلا سيئر
ةوهش ايندلا نم يطعا نم لكو . هتبغر ةرخآلا نع تلق همه ايندلا ت |	ةوبشسامندلا نم ىطعا نم لكو . هتيغر ةرخآلا نع تلق همه انندلا ت
خارفلاو كمسلاو يلقابلاك اهريخبت رثكي يتلاو نارفعزلاو ةعيملاو  |	خارفلاو كتمسلاو ىلقابلاك اهريخبت رشلكتي يلاو نارفعزلاو ةعئيمل
يبويألا يرحبلا لوطسألا					      |	يبويآلا يرحبلا لوطسألا
اهنكمي ال ةيقالخا ةيبقانم ةيرظن ساسالا يف يه ثيح نم اهناو . ي |	ابكتم ال ةيقالخا ةيبقاغم ةيرظل سابسالا يف يف ثيح نف اهناف . ي
. ةماع ةفاقث ىلا بعشلا ةجاح ءامعزلا مهفت ىلع فقوتت	      |	. ةماع ةفاقث ىلاسعشلاةحاح ءامعزلا مهفت ىلع فقوتت
تناك ةعانصلا نا يا لماك لكشب مهريغ نع تاعانصلا اوذخا يسابعلا  |	تناك ةعانصلا نا يا لماك لكحثب مريغ نع تاعانصلا اوذخأ يمايعلا 
دادعالل يقيرفالا زكرملا : لاثملا ليبس ىلع اهنم ركذن اهتامهمب  |	دادعالل يقيرفالا زك رملا : لاثملا ليمس ىلع اهنم رك ذن اهتاهمب
ةينطولا حلاصملا قيقحت ىلع ممصملا لمعلا يه اـهتمهمف . ةيبيرجتل |	.ةينطولا حلاصملا قيقحت ىلع. ممصملا لمعلا يه اهتمههش . ةيبيرحت
. هدج يف نيضوفملا مهئارزوو ةيبنجالا لودلا لصانق نم مهرصاع نمم |	. هدح يف نيضوفملا مبئارزوو ةيبنحالا لودلا لصانق نم ممرصاع نمم
نييفحصلا ىلا نوعمتجي نيلوؤسملا لاـجرلا ةيبنجالا نادلبلاو ةيبر |	نايفحصلا ىلا توعمتم نيلوؤسملا لاجرلا ةسنحالا _'رادلبلاو ةيبرع
الو . ءانغلاو صقرلا اهللختي ةجهبم ةحرم ةرتف ءاضقل نوتأي ةرواج |	الو . ءانغلاو صقرلا اهالختي ةجهمم ةحرم ةرتف ءاضقل نوتأي ةرواو
ريرحتلا ةنجل						      |	ريرص ني
نا نكمي لاملا سأر يف ريفوت نم كلذ عبتي ام نا . ةريغصلا ةيجاتن |	نا نكمي لاملا سار يف ريفوت نم كلذ عبتي ام نأ . ةريغصلا ةيجاتن
مه طسوالا قرشلا يف تاموكحلا يفظومو لامعالا باحصا نا فورعملا   |	مه طسوالا قرشلا يف تاموكحملا يفظومو لامعالا باحصا نأ فورحملا
. ةيلاملا اهئابعاب مايقلا نم اهنيكمتل ةلاكولا قودنصل عربتلا ى |	. ةيلاملا امابعاب مايقلا نم اهنيكدلل ةلكولا ىودنصل عربتلا ىلع
ةنيدملا ةالو						      |	ةديدملا ةالو
لوعفم ءاـهتنا نع ءىشانلا عـضولا يف اورظنو نيدلبلا مهت يتلا رو |	لوعفم ءابتنا نع ءىثانلا عضولا يف اورظنو نيدلبلا مهت يتلا روما
. يكريمالا لخدتلا بجشي ناريسع لداع ديسلا ينانبللا يباينلا سلج |	. ىريمالا لخدتلا بحشي ثاريسع لداع ديسلا ينانمالا يلانلا سانا 
. مامتهالا قحتسي نيئجاللا لجال				      |	. ماجهالا قحتسي نيئحاللا لحال
امذ الا يتجهم يف عدي مل					      |	امذ الا ىتحبع يف عدب مل
. لوهجم ليصحت ىلإ يدؤي هجو ىلع تامولعملا بيترت ةيفيك نع ثحاب  |	.لوهجم ليصحت ىلإ يدؤي هجو ىلع تامولعملا بيترت ةيفيك نع ثحاب م
ةيقافتالا بجومب ةيقارعلا ةموكحلا ىضاقتتسو . قافتا ىلا قارعلا  |	ةنقافتالا بجو# ةيقارلا ةموكسللا ىضاقتتسو . قافتا ىلا قارعلا ي
ةقيقح نيخرؤملا اوربخي ىتح ىزغملا نوملعي اونوكي مل ةبصنالا هذه |	هةيقح نيخروملا ادربخي قح ىزغملا نوملعي اونوكي مل ةبصنالا هذه 
يناه نبا						      |	 يناه نبا
ناب داقتعالا ىلا ليمن اننا ريغ . حضاو دحاو ىنعم ىلا اهدر ثحاب |	ناب داقتعالا يلا ليم اننا ريغ .حضاو دحاو "ىنعم ىلا اهّدر ثحابل
- - - - - - - -						      |	هد س سادشد س ساسا مأ
. رهقلا ىلع ءاوتسالا					      |	.رهقلا ىلع ءاوتسالا
نم ةريبك ةجرد ققحت ةيداصتقالا طباورلا ناو ايداصتقا رخالا امهن |	نم ةريبك ةجرد ققحت ةيداصتقالا طباورلا ناو ايداصتقا رخالا اهنم
ريفوتلاو داصتقالاو هيف ةدوجوملا تالوكأملا ةحصو ةفاظن ىلع ةظفا |	ريفوتلاو داصتقالاو هبف ةدوجوملا تالوك أملا ةحصو ةفاظن ىلع ةظف
ةليمجلا نونفلا						      |	ةليمحلا نودعلا
فرصملا يف ةيدقنلا اهلاوما نم ءزج عادياب اهمازلاوً اقبسا انرشا  |	فرصملا يف ةيدقنلا اهاوما نم ءزج عادياب اههازلاو أاقباس انرشا 
. ةعساو ًاـقافآ انماما حتفي عونلا اذه نم ًايرابتخا اًلمع نا . ةب |	. ةعساو ًاَقاف آ انماما متفي عونلا اذه نم ًايرايتخا المع نا . ةي
ارارم حرص دق رطاخ روتكدلا نا اصوصخ ةبقاع ملسا وه يفرحلا لقنلا |	ارارم حرص دق رطاخ روتك دلا نا اصوصخ ةيقاع ملسا وه يفرحلا لقنل
سلدنالا يف يبدالا دقنلا خيرات يف ةيانعلا قحتسي دحاو رهظم كلذ  |	سلدنالا يف يبدالا دقنلا خيرات يف ةيانعلا قحتسي دحاو ربظم كلذ 
لامعالاب مايقلاو ةرادالا ماهم ذخال نييلحملا ناكسلا بيردت ىلا  |	لامجالابمايقلاو ةرادالا ماهم ذخال نييلملا ناكسلا بيردت ىلا نو
ةعانصلا جاتنا لوح ةيئاصحالا تامولعملا رشنو ليلحتو عمجل دادعتل |	ةعءانصلا ماتنا لوح ةيئاصحالا تامولعملا ريشنو ليلحتو عمجب دادع
اياضق يف كلذ نم يهتني ام اريثكو ظافلالاب فرصتلا نسحي يذلا نان |	اياضق ىف كلذ نم ىبتني ام اريثك و ظافلالاب فرصتلا نسحب ىذلا نا
لـبقلا تاـيهشم يناوحقألا اـهرغث اياـنث مـساـبملا رـمح	      |	لبقلا 2 تايهشم  يناوحقألا اهرغث ايانثث ٌممابملا رمح
ةكرتشملا حلاصملل ىلعالا سلجملا ىلا اهميلست ةسنرف ىلع بجاولا م |	ةرتشملا ملاصملل ىلعالا سلجملا ىلا اهميلست ةسنرف ىلع بجاولا مق
ةلماح ردصت ةيداعلا ةنمزالا يف دئارجلا لعجي ام اذهو نوصتخملا ا |	ةلماح ردصت ةيداعلا ةئمزالا ىف دنارخأ لعجيام اذهو نوصتٌغا اهورر
ثاحبالا هذه لعج يف اهعم نواعتلل صاصتخالاو ركفلا لاجر وعدت يهو |	ثاحنالاهذه لعج ىف ابعم ثواعتلل صاصتخالاو ركفلا لاحر وعدت يهو
.ً اضاي باتكلل						      |	. أضنا باتكلل
سيلو . اهيأرب ديقتي الو ةلودلا نوؤش يف اهيلا عجري ةنيعم ةئيهب |	سيلو . اهيأرب ديقتي الو ةلودلا نوؤس يف اهيلا عجرب ةنيعم ةئمبب
ىلع داقعلا دمحم روهمجلا برطيو				      |	ىللع داقعلا دمحم روهمجلا برطيو
. ةيرحلاو لالقتسالا لظ يف ةسدقملا ةينمالا هذه قيقحت	      |	. ةيرعاو لالقتسالا لظ يف ةسدقملا ةمنمالا هذه قيقحت
كلذكو . مويلا اـهريغ يه اماع نيسمخ ذنم ةينانبللا ةيماعلاف     |	كلذك و . موملا اهريغ يه اماع نيسمخ ذنم ةينانبللا ةيماعلاف
روصلاو موسرلاو طئارخلاب دوزمو بهسمو عئار ريرقتلاو . اهملاعم ر |	روصلاو موسرلاو طئارخلاب دوزمو ببسمو عئار ريرقتلاو . اهملاعم ر
. هيلع تلصح يذلا لعفلا در				      |	. ةيلع تاصخ ىدلا لعفلا در
ةحلسالاب ةصاخلا ةيلاملا لئاسملا ضعب ثحبو تاعوفدملا ميظنت نأشب |	ةحاسالاب ةصاخلا ةيلاملا لئاسملا ضعب ثحبو تاعوفدملا مظنت تأشب 
ناتنثا اهنم ابيرقت نوعبرا ةكلمملا ىف ةثيدحلا ةيئادتبالا سرادم |	ناتنثا ابنم امدرقت نوعيرا ةكلامملا .ىف ةثيدخلا ةيثادترالا سرا
يهو يمورلا قيرطبلا اهيلا راشا يتلا ةثالثلا بويعلا نع نيبتاكلا |	ىهو يمورلا قيرطبلا اهيلا راشا ىتلا ةثالثلا بومعلا نع نيبتاكلا
اـهنا ذا ةيح كش الو اـهنا حرصف يدنالوهلا كوهنوفيل وه قئالخلا  |	اهنا ذا ةيح كس الو اهنا حارصف يدنالوهلا كوهمنوفمل وه قئالخلا 
رخآ دلب ىلا ةعلسلا كلت عنص لقن ام اذاف . ريخلا يف ةدايزف ًانكم |	رخخآ دلب ىلا ةعلسلا كلت عنض لقن ام اذاف . ريخلا يف ةدايزف ًانك
لمعلل تاعامتجا اهنا ساسا ىلع ةمظتنم ةروصب هذهك تاعامتجا ينبت  |	لمعلل تاعاّتحا امبا ساسا ىلع ةمظنتنم ةروصب هذهك تاءاّتجا ىنيت د
يتلا لبانقلاف . ةيزاـنلاو ةيتسشافلا نايغط دض يملاعلا عارصلا ى |	يتلا لبانقلاف . ةيزانلاو ةيتسشافلا .نايغط دض ىملاعلا عارصلا ى
يبويالا نيدلا حالص					      |	ينويالا نيدلا حالص
نم ةيلامشلا قطانملا تناك رشع عباسلا نرقلا ةياـهن يفو . دالبلا |	نم ةيلامشلا قطانملا تناك رسشع عباسلا ىررقلا ةياسن يفو . دالمل
مهعئاقوب ًاينغتم ناشلا يوذ ىلا ًافلزتم يريمالا وهبلا وا يكلملا  |	مهعُت اقوب اشغتم ناشلا يوذ ىلا ًافلزتم يريمالا وهبلا وا يكتاملا
وا . اهتدابا ةيفيكو اهتشيعم قرطو تاعورزملاب ةرضملا تارشحلا سر |	وا . اتدابا ةيفبككو اهتشدعم قرطو تاعورزملاب ةرضملا تارشحللا س
ممالا ةبصع سلجم يف ةيوضعلا تناكف . ةدحتملا ممالا ةئيه اهدعب ن |	ممالا ةيصع سلح يف ةيوذعلا تناكف . ةدحتملا ممالا ةئيه اهدعب نم
. زايتمالا بحاص ىلا اهحابرا مظعم دوعيو سيراب يف اهلك فظوت تاك |	.زايتمالا بحاصملا اهحابرا مظعم دوعيو سيرابيف اهلك فظوتتاكن رف
نييرضحلا ناكسلا ةبسن					      |	نايرضخلا ناكسلا ةبسن
زاجحلا ةرادإ						      |	ئاسك ةرادإ
مهريغ دـحال قحي الو . تاوصالا زرفو تيوصتلا تايلمع بقاريو رضحي |	متريغ دحأل قحي الو . تاوصألا زرفو تيوصتلا تايلمت فقازيو رضح ن
نيلثمم دوجو ىلع يوطني مسالا نال انه مسالا اذه اهيلع قلطا نل ي |	نيلثم ةوحو ىلع يوطني مسالا نآل انه مسالا اذه اهيلع قلطا نأ يى
. يبرعلا قرشلا خيرات تلمش يتلا ةمجرتلاو فيلأتلا ةكرح طشنت نا  |	.يبرعلاق رششلا خيرات تاىش ىتلا ةحرتلاو فيلأتلا ةكرح طشنت نا ي
. يدرفلا دوهجملا عيجشت ىلا دالبلا ةجاح عم ضراعتي ام دوعولاو   |	. يدرفلا دوبجما عيجشت ىلا دالبلا ةحاح عم ضراعتي ام دوعولاو
. سميج . ربرث						      |	* سممح . رسصارت
لكشلا باـصا ديدجتلا اذه نا ملعن نحنو . ديدجتلا نم داقنلا فقوم |	لكشلا باصا ديدجتلا اذه نأ ىلعن ن>يو . ديدجتلا نم داقنلا ففقوم
وهو . دالبلا يف اهنوضقي يتلا ةدملا ةدايزو بناجالا نيحئاسلا دد |	وهو . دالبلا يف ابنوضقي يتلا ةدملا ةدايزو بناحالا نيغاسلا ددع
ضعب يوريو يناثلاو لوالا يسلا ىلا يهتنيف هترابع ةسالسو باذجلا  |	ضعب يوريو يناثلاو لوالا يسلا ىلا ىهتنف هتوابع ةسالسو باذملا ى
ىلا ايناطيرب نم رفسلل الثم ةماعلا ةحصلا وا بلقلا ةحارج يف نيي |	ىلا امناطيرب نم رفسلل الّثم ةماعلا ةحصلا وا بلقلا ةحارح ى نيصا
زاهجلا نع هريرقت يف دراولا ركنس لوب ريسلا يأرً اضاي وه اذهو .  |	زابملا نع هريرقت ىف دراولا ركنس لوي ريسلا يأر أضيا وه اذهو . 
مالا ةبرلا وا تيدورفا مسا اوسانت نكلو تيزلاب هتراجح نوحسميو م |	مالا ةيرلا وأ تيدورفا ممأ اوسانت نكلو تيزلاب هتراحح نوحسمعو م
. ةنامورلا ةريظحلا ىلا ةلتحملا				      |	. ةمنامورلا ةريظألا ىلا هتحلا
. وفعلا حارتقا لبق ةفرتقملا مئارجلا نع ماعلا		      |	. وذعلا حارتقا لبق ةفرتقملا مثارطا نع ماعلا
دبع بيج لسرا ظفل يفو ىرداوقلا قاذرلا دـبع ديسلا ىلا بسلاو متش |	دنع بيح لسرا ظفل ىفو ىرداوقلا قادرلا ليع ديسلا ىلا بسلاو مشلا
ىلع ثحبلا كلذ يف امب ةكرتشم ةعفنم تاذ نوكت ةمئاقلا لكاشملا ضع |	ىلع ثحبلا كلذ يف ام ةك رتشم ةعفئنم تاذ توكقت ةمئاقلا لك ادْلا 
. ةرافس ةجرد ىلا نيدلبلا نيب يسامولبدلا ليثمتلا عفر ررقت دقو  |	. ةرافس ةحرد ىلا نيدلبلا نيب يسامولبدلا ليثمتلا مفر ررقت دقو
. اهاوه عبتي						      |	, اهاوه عش
ناجشا . ليصالا حابشا . ةريهظلا جهو . حابصلا ةظقي : نم سبتقم . |	نراخشا . ليصالا حاشا . ةريبظلا جهو . حابصلا ةظقي : نم ستقم , 
نم صوصنلاو بتكلا هذهل امل ثحبلا اذهل ددحملا رصعلا لالخ ترشن ي |	نمصوصنلاو بتكلا هذهل ال ثحبلا اذهل ددحنا رصعلا لالخ ترشن ىتلا
بعشتم صصختم زاـهج ةطخلا هذه جمارب ذـيفنت ىلع فارشالا .	      |	بعشتم صصختم زاهج ةطخلا هذه جمارب ذيفنت ىلع فارشالا 
: بساحلا نبا نيحلت نم وهو يسنلبلا قاقزلا نبا رعشو	      |	: بساحلا نبا نيحلت نم وهو ىسنلسا ىاقزلا نبا رعشو
نع هـتمتاخو هايملاو ةعارزلا نع لصف هيفو . هلودلل ةيبنجالاو ةي |	نع هنتاخو هايملاو ةعارزلا نع لصف هيفو . هلودلل ةسنحالاو ةيبرع
يحاونلاب نومتهي لئالق نيربخم ىلع دمتعت ةيبرعلا دئارجلا امنيب  |	يحاونلاب _هو.تمي لئالق نيربخم ىلع دمتعت ةيبرعلا دئا را انيب ر
ةمظنالاو نيناوقللً اقوف اهلبق نم اهلامعتسا نكميو ةلماكلا ةيسنر |	ةءظنالاو نيناوقلل ًاقفو املمق نم اهلاعتسا نكميو ةلماكلا ةسنرفل
ةيلخلا ةدحو بهذم قاثبنا دهاش يذلا ًابيرقت ليجلا سفن يف سوردلا  |	ةءاخلا ةدحو بهذم قاثنا دهاش يذلا ًاسرقت لملا سفن يف سوردلا هذه
الا مهللا - رخآ بعش اهيلا مهقبس املق ةجرد ىلا لصو يذلا نوناقل |	الا مهللا - رخآ بعش اهيلا مهقبس اماق ةجرد ىلا لصو يذلا نوناقل
ودبيو . ًايعوضومً اخرمؤ الً اعفامد ًارشبم ةيميت نبا نع هتباتك يف  |	ودسو . ًاعوضوم أخرؤم ال ًاعفادم ]رشيم ةيميت نبا نع هتباتك ىف نا
تاضواـفملا يف لوخدلا نم ريغلا عنمي ال هسفن ةصاخ يف ةطخلا هذهب |	تاضوافملا يف لوخدلا نم ريغلا منمي ال هسفن ةصاخ يف ةطخلا هذبب 
ةماقاب حمس دق ةدحتملا ممالا ةمظنم يفً اوعض ةيدوعسلا ةيبرعلا ةك |	ةماقاب ممس دق ةدحتملا ممالا ةمظنم يف ًاوضع ةيدوعسلا ةيبرعلا ةك
ةيبرعلا لودلاو نانويلا يف تمقافت نا تثبل ام نيدرـشملا نيئجالل |	ةسسرعلا لودلاو نائوملا ىف تقافد نا ثّثبل ام نيدرسملا نيثحاللا 
ةيناملرب تاراشتساب ةيروهمجلا سيئر موقي نأب ينانبللا يسايسلا ف |	ةيناملرب تاراشتساب ةيروهمجا سيئر موقي نأب يناتيللا يساسلا فرع
باتكلا راد						      |	كائشخاإد
ةقيرطلاف . مدآ ءانبأك ةريثك هللا ىلا قرط ةيفوصلا لوقي امك كان |	ةقيرطلاف .مدآ ءانبأك ةريثك هللا ىلا قرط ةمفوصلا لوقي اك كانبف
ةركف تناك . ةررحملا ةيبرتلا هنمضتت نا بجي ام يف نيعم دحل ولو  |	ةركف تناك .ةررحغأ ةيبرتلا هنمضتت نأ بحي ام ىف نيعم دّخ ولو راث
أدبت هرفطلا نانظيو . تانيجلا رغصل هتيؤر نكمي ال تانيجلا ةعيبط |	أدت هرفطلا نا نظيو . تانيطا رّمصا هتيؤر نكسمي ال تانيحلا ةءيط 
: ةيسايسلاو ةيعامتجالا فورظلا ببسب ةعئاضلا ةيرشبلا دراوملا :ً  |	: ةمسامسلاو ةيعاتحالا فورظلا بيس ةعئاضلا ةيرششلا دراوملا : ًاع
. قارعلا كلم ينانلا لصيف كلملا				      |	٠. فقارعلا كلم ىبالأ لصيف كلملا
. يرئازجلا يعويشلا بزحلا لحب الليب نب دمحا يرئازجلا سيئرلا رم |	. يرئازجلا يعويشلا بزكلا لحب اللس نب دمحا يرئازجلا سيئرلا رمأ
. تاليهستلاو ينابملا متت املاح				      |	. تاليبستلاو يفابملا متت املاح
. ةيعقاو فادهألا نوكت نأ يغبني -			      |	.ةيعقاو فادهألا نوكت نأ يغبني -
روحالا لازغلاك ينانج يروح رمسالا بيضقلاك ىنثت رمسأ	      |	روحالا لازغلاك ىنانج ىروح  ٌرمسالا بيضقلاك ىنثت رمسأ
رايتخالا قح اهبجومب حنم يتلا ىرخالا تاطلسلا عـيمجل هتسرامم دن |	رايتخالا قح اهبحومم حنم يلا ىرخالا تاطلسلا عيمب هتسرام دنع هر
نا ينانبللا يعانصلا دادعتلا نع ريراقتلا أرقي نمل رهظيو . ةيعا |	ىرأ ىفاتيللا ىعانصلا دادعتلا نع. ريراقتلا أرقب نأ ربظبو . ةيع
يسآم نم ةيناث ةاسأم ىلع راتسلا لدسا ةنسلا كلت يف - انخيرات يف |	ىمام نم ةيناث ةاسأم ىلع راتسلا لدسا ةئسلا كلت ىف - انكراتىف ة
هل عضخي ًاـتباثً امانظ ملاعلا يف ناب يعيبطلا نوناقلاب نونمؤملا  |	( عضل ]تباث ًاماظن ملاعلا يف ناب يعببطلا نوناقلاب نوئمؤملا لاق
ثاحبألا							      |	تاحلا
تاداقتنا دض هدعاسو هججحو يبلكلا نبا ءارآ نم ربكالا مسقلا تبثأ |	تاداقتنا دض هدعاسو هججحو ىلكلا نبا ءارا نم ربكالا مسقلا تبثأ 
توريب يف ةيكريمألا ةعماجلا اـهردصت ةلجم			      |	توّربإ كدمألا تماجبا ايحررصنرب
. مامالأ ىلا ةيندملا عفدي نأو ةننوكلاو نوكلا قيرط	      |	. مامالأ ىلا ةيندملا عفدي نأو ةننوكلاو نوككلا قيرط
. اذه ضيقن ىلع رمالا لب فلحلا وا			      |	. اذه ضميقن ىلع رمالا لب فللا وا
. بيجن دمحم ماعلا دئاقلاو يكريمالا ريفسلاو اشاب رهام يلع سيئر |	. بيجن دمس ماعلا دئاقلاو جكريمالا ريفسلاو اًساب رهام ىلع سيئرل
ىأر نم لواو . رطفلا روذبو ةريمخلا ايالخ اوأرو ةملاسملاو ةراضل |	ىأر نم لوأو . رطفلا روذبو ةريجلا ابالخ اوأرو ةملاسملاو ةراضلا
: ةيلاتلا ماكحالا نم ودبي امك ةيمكلا ثيح نم فيلستلا ديدحت :ً ا |	: ةيلاثلا ماكحالا نم ودبي ام ةيمكلا ثيح نم فيلستلا ديدحت : آل
. نيعم يـنس ميعزو ةيروهمجلا سيئر نيب أشنت يتلا ةديطولا تاقالع |	. نّبعم يّنس معزو ةيروهما سيئر نيب أشنت يتلا ةديطولا تاقالعلا د
ةسايسلل مت اذا هناف اذهلو . ةراسخب انايحا اهعيبو جراخلا ىلا م |	ةسايسا[ مث اذا هناف اذهو .ةراسخانامحا اهعيبو جراخلاىلا مهعئاض
عمتجملا لجا نم لمعلا ىلع ءاضعالا بردتف اهلامعا ذيفنت يف ةيبزح |	عيشلا لجا نم لمعلا ىلع ءاضعالا بردتف اهلاءءا ديفنت يف ةيبرالا
يبرـعلايملـعلا ركـفلا روطت				      |	قرسلايلاايلار وطت
. دالبلا						      |	, هالمأا
. نامع يف يناطيربلا لخدتلا دض ةدحتملا ممالا ىلا ًاجاجتحا ةيقير |	. نا.ء يف يناطي ريلا لخدتلا دض ةدحاملا مهالا ىلا ًاحاحتحا ةيقي
ءابنالا تالاكو تماقو . ةلوهسب هعفدت نا ةديرجلا عسوب ًالوقعم ًاك |	ءابنالا تالكو تماقو .ةلوهسب هعفدت نا ةديرجلا عسوب ًالوقعم أك ا
. ةيرشبلا اهاوقل طيطختلا ىلع ةسسؤملا			      |	. ةيرشسملا اهاوقل طيطختلا ىلع ةسسؤملا
. لخدلا ىوتسم طوبه متحتيف فيظوتلاو			      |	. لخدلا .ىوتسم طوبه ممحتبف فيظوتلاو
نويع ناهرلا موي اهب تقلع اـهنا ال اـهقبس ةعاسب تفرع	      |	اكوبع تاهرلا::موي اب تقلع ابهنا ال اهقبس ةعاسن ٍتفرع
تضق ثيحب ينامورلا مالسلا بابشلا دهع يف ةيريشبتلا برحلا تطشن د |	تضق ثدحيلام ورلا مالسلا باشلا دهعيف ةيريشدتلا ب رخا تطشن دقف.
لب ًاـعبارم سيل هناف لوصحملا نم هتصخ ذـخأي ناك ناو عرازملا نا  |	لب ًاعبارم سل هناف لوصحملا نم هتصخ ذخأي ناك ناو عرازملا نا ا .
. عمتجملا ةحلصم عم وا نيرخآلا قوقح عم ضراعتت ال تماد ام اهدكؤ |	. عمتجملا ةحلصم عم وأ نيرخآلا قوقح عم ضراعتت ال تماد ام اهدئو
يفو ريصملا ريرقت يف نيينادوسلا قحبً اديوط ًاناميا ةيرصملا ةموكح |	ىفوريصملا ريرقت ىف ثيينادوسلا قحي ًاديطو ًاناعا ةيرصملا ةموكملا
هبولساو . حالصالا لجا نم ةقداص ةينطو ةبغرب هتجلاعم يف عوفدم ف |	ةيولساو . حالصالا لجأ نم ةقداص ةينطو ةيغرب هتجلاعم يف عوفدم ف
لاملا مئارج وا لجرلا نيا				      |	لاخلا تارج وأ لحرلا نا
نانبل - توريب						      |	نانتل - توزيتب 
نم لئاسلا ركسلل لمعمو ةيعارز تاعانصو ديدحلل رخآو قرولا لمعمو  |	عرم لئاسلا ركسلل لمعمو ةععارز تاعانضو ديدحال رخنآو قرولا لمعف
لمحتتل ةيعيرشتلا سلاجملا هذه ةيوقت مويلا ةيطارقميدلا تابجاو م |	لئختتل ةيعيرشتلا سلاجملا هذه ةنوقت مويلا ةيطارقيدلا تابجاو مه
ةدحتملا ممالا اهب تصوا يتلا فيراعتلا عم قفتت لوالا ريرقتلل ةم |	ةدحتملا مهالا ا,تصوأ ىبلا فيراعتلا عم قفتت لوالا ريرقتلل ةمدق
تاريخلا هذه ىلع اولصحيل مهعسو يف اـم لك اولمعي نا مهبولق يف ا |	تاريكبا .هذه ىلع اواصخبل ميعسو يف ام لك اواءعي نا مهبواق يف ا
وا ةلادعلا ققحيل نكي مل ماظنك وهو . سسالا هذه هل اـملاط كلذ س |	وأ ةلادعلا ققحيل نكي مل ماظنك وهو . سسالا هذه هلا ح لاط كلذ س
ررحم يتيام نم برقي ام ةيكريمالا دئارجلا ضعب ريرحت مسق يف تدها |	ررحع يتبام نم برقي ام ةيك ريمالا دئارطا ضعب ريرت مسق ىف تدهاش
. تانب ثالثو						      |	. تانش ا ثالثو
ةربخلا لها مامتها ريثي نأب ريدج نابانكلا اهاوتحا يتلا ةداملا  |	ةريللا لها ماتها ريث تأب ردح تاباتكلا اهاوتحا قلا ةدالا نم.رب
ةيميظنتلا ةطلسلا					      |	ةميظتتلا ةطلسلا
اـمبر وا انب بهشلا تراغ					      |	امير ىا انب ببشلا .تراغ
ًاحاحلإ دشا ليماسرلا ىلا ةجاحلا تحبصا نيئجاللا ليس قفدتبو . اه |	احالإ دّسا ليماسرلاىلا ةجاطلا تحصا نيثحاللا لهسؤةدتيو .اهناكتس
ريبكلا جاتنالا نمضتي ينفلا ءامنالا نا ريغ . ةدحتملا تايالولاو |	ريبكلا جاتنالا نمضتي ينفلا ءانالا نأ ريغ.ةدحتملا تالايولاو اب
لصح وا ةباتكلا ءانثا أطخلا نم ءيش ديلولا ةملك ىلع أرط - أ : ت |	لصح وا ةياتكلا ءانثا أطخلا نم ءىش دملولا ةملك ىلع أرط -أ : تا
ةغللا لخدت يتلا ةديدجلا يناعملا نا ظحالن ةيناث ةهج نمو	      |	ةغللا لخدت ىتلا ةديدجلا يناعملا نا ظحالن ةيناث ةبج نمو
. اـهيلع ءاقبالا نم نالا ىتح اشاب مازع			      |	. اهملع ءاقبالا نم نالا ىتح اساب مازع
عورشملا ةمدقم يف نيئجاللا ةـثاغا ةئيهل ماعلا ريدملا رفراك يلس |	عورشملا ةمدقم يف نيئِجاللا ةئاغأ ةئيهل ماعلا ريدملا رفراك ىلسل
. ةنيعم دودح اهل قطانم نع نيلوؤسم نييرادا		      |	.ةنىم دودح ال قطانم نع نياوؤسنيدرادا
ىلا طيحملا نم قيرط وه اهنم عاعش لكو . قرطلا ىلا زمرتف هعشالا  |	ىلا طيمملا نم قيرط وه ابنم عاعُش لكو .قرطلا ىلا زمرتف هعشالا ا
. ةغللا صخت تاحلطصمو - ىنعملا نم - ةيونعم تاحلطصم نيب	      |	. ةغللا صخت تاحلطصمو  ىنعملا نم  ةيونعم تاحلطصم نيب
تاعورشملاا هذه ذيفنت متي فيك . . وه لاجملا اذه يف هتراثا نم د |	تاعورسملا هذه ذيفنت متي فيك ..وه لاجما اذهيف هتراثا نم دب ال 
. يناليكلا ءايمل ةسنالل روصعلا مدقا ذنم طسوالا قرشلا	      |	. يناليكلا ءامل ةسنالل روصعلا مدقا ذنم طسوالا قرشلا
مجن فسوي دمحم						      |	.مجت فسون دمح
ةعوطقم ةروصب مزاوللا هذه ردقت . تاعطقلل ةيداعلا تاصصخملا نع ة |	ةعوطقم ةروصب مزاوللا هذه ردقت . تاغطقلل ةيداعلا تاصصخما نع ةد
اـهيمسي ةيبرتلا نم ًاعون يسابعلا رصعلا يف كانه نا ىري اًلثم يتح |	اهيمس ةيبرتلا نم ًاعون ىسايعلا رصعلا يف كانه نا ىري الثم ّىح رو
ةعيبطلا رعش						      |	ةعماطلا رعش
. ةماركلاو قحلا عالق نم ةخسار ةعلق			      |	. ةماركلاو ىلا عالق نم ةخسار ةعلق
. ةرقنا يف ضوفملا ندرالا ريزوو ناتسكابلا		      |	. ةارقثا يف ضوفملا ثدرالا رزوو تاتسك املإ
ىلا برقا دهعلا كلذ فرع يف وهف . اهعرزي يتلا ضرالا نم ًاءزج تقو |	ىلا برقا دبعلا كلذ فرع يف وبف . ابعرزب ىتلا ضرالا نم ًاءزج تقو
. هيف مهكامسأ نوعيبي رخآ عضوم ىلا نورجهيو كامسألا	      |	. هيف مهك امسأ نوعيبي رخآ عضوم ىلا نورجبيو كامسألا
وكسوم يف ةدحتملا ةيبرعلا ةيروهمجلا ةرافس نع ردص نايب يف ملاس  |	وكسوهيف ةدحتملا ةيبرعلا ةيرويمحا ةرافس نع ردص تايبيف ملاس حال
يقالخالا رايتلا بايسنا وه يناثلا فرطلاو سلدنالا بدأ نع عافدلا |	يقالخالا رايثلا بايسنا وه يناثلا فرطلاو سادناألا بدأ نع عافدل
ال نيذلا ليجانالاو ةاروتلا ءاملع ددع نوكي نا ىشخاو . ةىيخيرات |	ال نيذلا لمحانالاو ةاروتلا ءامع ددع نوكي نا ىشخاو . ةمخراتلا 
راطخا ءردو نزخلاو فيرصتلاو يرلا عيراشم نع ًادج ةرصتخمب ةرظن هذ |	راطخا ءردو نزلاو فيرصتلاو يرلا عيراشم نع ًادج ةرصتخم ةرظن هذه
دوجو ىلع ةمزاج ةروصب لدت اـهيف ةيباينلاو ةيدلبلا تاباختنالا ر |	دوجو ىلع ةمزاج ةروصب لدق ا بمف ةيباسشلاو ةيدلبلا تاباختنالا ر
. مهلكاشملو ةيعامتجالا ةمدخلا لقح يف لامعلل اهسفن سركتو	      |	٠ مهاك اشملو ةيعاتجالا ةمدخلا لقح يف لاعلل اهسفن سركتو
امدنعو خلا . . بيبطو مكاحو يرادا فظوم اهلو ةرادا سلجمو يدلب س |	امدنعو خلا .. بيبطو 5 احو يرادا فظوم املو ةرادا سلجمو ىدلب سل
ليجلا يف ةركاب ةيلمع يه ةبورعلا ءاحنا عـيمج ىلع تادرفملا ةمئا |	ليجلايفةركاب ةيلمع يه ةيورعلا ءاحنأ ميمج ىلع تادرفملا ةّماق مم
تدقعت عمتجم يف ةيعامتجا ةايح اوشيعي نال دارفالا دادعا اـهنم ض |	تدقعت عمتجم يف ةيعاّتجا ةايح اوثيعي نال دأرفالا دادعا اهنم ضرغ
. ةـيعامج تاقافتا قيرط نع رحلا ملاعلا راطقا نيب ةراجتلا عيسوت |	. ةيعاج تاقافتا قيرط نع رخلا ملاعلا راطقأ نيب ةراجتلا عيسوت ى
. نانبل يف ًايبسن بلغت ةيراجتلا ةفصلا نا ولو نايراجت نادلب اير |	. نانمل يف ًاسسن فبلغت ةءراحتلا ُةفضلا نا ولو نارراُت نادلب ابرو
ةريثكلا مولعلا نم دادمتسا هلو لدجلا ملع نم ةطبنتسم هئدابمو .  |	ةريثكلا مولعلا نم دادمتسا هلو لدحلا ملع نم ةطبنتسم هئدابمو .ه
ةكرتشملا تاسلجلا					      |	ة* رثشملا تاساملا
. مهدماحم الملا يف ًارشانو				      |	. مهدما# الملا يف ًارشانو
لوالا هدع دقف . توقايو يدوعسملا مهزربا نم ءايوقا ءارصن يبلكلا |	لوالا.دع دقف .٠ توقايو يدوعبسملا مززبا ن.ه ءايوقا ءارسعن يلكل
اولحف ةئيسلا لاحلا كلتب انودجوف انيلا موقلا لبقاف انتلمحي انح |	اولحف ةئيسلا لاحلا كلتب انودحوف انملا موقلالمقاف انتلمح انحصف
ريـنلا تحت تعقو يتلا نادلبلا هذه يف راج وه امب ربتعي ال نمو . |	رينلا تحت تعقو ينلا نادلبلا هذه يف ٍراج وه اب ربتعي ال نمو . د
اـهنكلو ! قيش لهس سرد نم هل اي ! ةينفلا هنازيمو يلهاجلا رعشلا |	ابنكلو ! ىتش لهس سرد نم هلاي ! ةينفلا هتأازيمو ىلهالا رعشلا ض
يف لب نيطسلف ىلا مهتدوع يف نوكي ال مهصالخو . ساـنلا ىلع هورشن |	يف لب نيطسلف ىلا مهتدوع يف ثوكي ال مهصالخو . ساالا ىلع هورشنب
نطاوملا ىتح همعدي مل اذا ًاقالطا حالصإلا اذـه يرجي ال دقو . سا |	نطاوملا ّيح همحدي مل اذا ًاقالطا حالصإلا اذه يرحي ال دقو . سانل
. رمالا اذهب ةينعملا نادلبلا عميج ةراشتسا كلذ ولتي نا يغبني ه |	.رمالا اذهب ةينملا نادلبلا ميج ةراشتسا كلذ ولتي نا يثبني هنأ 
. اهتينازيم						      |	. اهتينارلم
ةليسو ريخو . ةكرتشملا ةيئاشنالاو ةيعينصتلا جماربلا ذيفنتو عضو |	ةلمسو ريخو . ةكرتشملا ةيئاشناللو ةيعينصتلا جماربلا ديفنتو عضو
. انرظن ةهجو معدي ام ابوروا يفو ةيكريمالا		      |	, انرظن ةبحو معدي ام ابوروا ٍثو ةيك ريمالا
ةمزاللا قوسلا نامضو ةيلحملا دراوملا ىلا تاعانصلا هذه دانتسا م |	ةمزاللا قوسلا نامضو ةيلحملا دراوملاىلا تاعانصلا هذه دانتسا مو
معدب ةيئاضقلا تائيهلا هذه تعتمت دقو . اهدهعتو دارفالل ةعورشمل |	معدب ةيئاضقلا تائمهلا هذه تعتم دقو . اهدبعتو دارفالل ةعورشملا
. ةرادالا فرصت تحت يتلا ةيجاتنالا			      |	. ةرادالا فرصت تحن ىتلا ةيحاتنالا
براجت هيلا تهتنا امبسح فيرلا ةمدخل نيئيهمو ادادعا نيدعم اصاخش |	براجت هيلا تيتنا امسح فيرلا ةمدخل نيئيبمو ادادعا نىدعم اصاخشا
عئاقولا لسلستو ثدحلا ىلع دمتعت يتلا ةيمحلملا لامعألا يف هدهشن |	عئاقولا لسلستو ثدحلا ىلع دمتعت يىلا ةيمحلملا لامعألا ين هدهشن
ةلود يا ءازا يناودع لمع ياب مايقلا مزتعت ال ةيرتشملا ةلودلا ن |	ةلود يا ءازا يلاودع لمع ياب مايقلا مزتعت.ال ةيرتشملا ةلودلا ن
ةرواجملا ممالا نع مالكلا ىلا اهنزواجتي دقو ةيبرعلا دالبلا راب |	ةرواجتا ممالا نع مالكلا ىلا اهنوزواجتي دقو ةيبرعلا دالبلا راب
ةرمغ يف اهفالتخا ىلع مهراثآ ترمطناف دمألا ليوط مظنم داهطضال ا |	ةرمغ يف اهفالتخا ىلع مهراثا ترمطناف دمألا ليوط مظنم داهطضال ا
نا وه ةـحنجالاو شارفلا نيب قرفلا نكل . ةرئاطلا ةحنجا عطقم هبا |	ّتمأ وه ةحئجالاو شارفلا نيب قرفلا نكل . ةرئلا ةمتجا مطقم هباشب
خيراتلا مهفت ىلع امئاق ًافطع اهتيضقو ةأرملا ىلع ًافطع ءالتما دق |	نيراتلا مهفت ىلع .امثاق افطع !متيضقو ةأرملا ىلع أفطع ءالتما د
؛ ةلودلا ةدايس ةيرظن : ةيسيئر مئاعد ثالث ىلع يبرغلا ةلودلا ما |	؛ ةلودلا ةدايس ةيرظن : ةيسيئر متاعد ثالث ىلع يبرغلا ةلودلا ما
بيهصل هللا رفغ - ١					      |	بيسصل هللا رفغ -أ
نورشعلاو ةسماخلا ةداملا					      |	نورشعلاو ةسماخلا ةداملأ
نيتئام ىلاوح ةدوع ىلع تقفاو ليئارسا نا سدقلا يف ةندهلا ةبقارم |	نينثام ىلاوح ةدوعلع تقفاو لمئارسا نا سدقلا يف ةندحلا ةيقارم ة
ىلع وا - ةيملاعلا حمقلا ةراجت يف ًاماه ًازكرم ايروسل نا ةلهو لو |	ىلع وا - ةيملاعلا ميمقلا ةراحت يف أماه ًازكر م ايروسل نأ ةلهو 
. ةينيلرتسا ةريل فلا نيثالث				      |	. ةينلرتسأ ةريأ فلا نيثالث
ةيرامعتسالا رشع عساتلا نرقلا ةسايس قيبطت يف رارمتسالا يلا ةـي |	ة:رامعتسالا رشع عساتلا نرقلا ةسايس قيبطت يف رارمتسالا يىلا ةب
أدب دق ناك هاجتالا اذه نا يف كش الو . ركفلاو لقعلا ةيمنتو كول |	ًادب دق نراك هاجتالا اذه نا يف كش الو . ركفلاو :لقعلا ةسئتو كو
: ةريخالا تاونسلا					      |	: ةريشالا تاوئسلا
عومجم يف ًادج ةريبك ةيمها اهل نوكي دق هذهو نانبل يف لامع ةثالث |	عومج . يف ًادج ةريبك ةيمها ال نركي دق هذهو نانيل. ىف.لاع ةثالث
ناـطلسلا ةوق تأدب امدنع ةيبرعلا دالبلا يف ةيكلملا ماظن يف يلع |	ناطلسلا ةوق تأدب امدنع ةيبرعلا دالبلا يف ةبكلملا ماظن يف ىلعف
هيلا راشملا باتكلا يف امهتبثاو نأشلا اذه يف يارغ امهارجا رابت |	؛نلا راشملا باتكلا ىف اهتيثاو نأشلا اذه يف يارغ اهارجا رامتخا
كلذكو . نيينعملا ضارقنا دعب نييباهشلا ىلا ةرامالاب دهع ةيناقم |	كلذك و .نيمنعملا ضا رقنا دعي نيساهشلاىلا ةرامالاب دبع ةيناقمس
كلاذب نوكي هنأل ءيش هل نكي مل ناقح امهن : لاقوً اعيجم نادهاشلا |	كاذب نوكي هنآل ءيش هل نكي مل ناقح امهنا : لاقو ًاعيمج نادهاشلا
اـيندلا وطخت نا تعطتسا ناف نوقابلا قرغيسو نوضاملا اهيف قرغ دق |	ايندلا وطخت نأ تعطتسا ناف ثوقاملا قرغيسو نوضاملا اهمف قرغ دق 
. نيساسب صمقت دوقرم وه : سيدقلا اذه رما نم ينرماخي ام كل تلق  |	.نيساسب صمقت دوقرم وه: سيدقلااذه سما نميفرما# ام كل تلق اذا ر
. نيماقملا نيب سبحلا : ةفقولا				      |	. نيماقملا نيب سسحلا : ةفقولا
ةـقطنملا ريخ هيف امل ةدافتسالا دودح ىصقا ىلاو ةيئاملا دراوملا |	ةقطاملا ريخ هنف اامل ةدافتسالا دودح ىصقا ىلآو ةيناملا دراوملا
ناـجللا لمعتو تاعامتجالا دقعتو تارضاحملا اهيف ىقلتو اليوط هذه |	ناجللا ليعتو تاءاتجالا دقعتو تارضاحملا اهيف ىقلتو اليوط هذه م
يتلا تالقنتلا ةرثك هيلا تدا يذلا صصختلا مدع نع ًاجتان تارازولا |	يتلا تالقنتلا ةرثك هيلا تدا يزلأ صصختلا مدع نع أمّتان تارازولا
. سانلا ريهامج لوانتم يف نوكي اًلقن ةفاقثلا لقنت يتلا ةديحولا  |	. سانلا ريهامج لوانتم يف نوكي اّلقن ةفاقثلا لقنت يثلا ةديحولا 
. نوعمش ليمك سيئرلا					      |	. نوعمش ليمك سيبرلا
. ملاعلا قطانم						      |	. ملاعلا قطاذم
دعب ةنس ةدحتملا ممالا ةئيه ىنبتت نا ريكفتلاو ةشهدلا ىلا وعدت  |	دعب ةنئس ةدحتملا ممالا ةّئيه ىنبتت نرا ريكفتلاو ةشهدلا ىلإا وع
بتك اـهنيبو بتكلا نومجرتي هذيمالتو ةعافر ذخاو يواطهطلا ةعافر  |	بتك ابذنيو بتكلا نومجرتي هذيمالتو ةعافر ذخأو يواطبطلا ةعافر د
: يلي امب ةتقوملا ةيذيفنتلا ةطلسلا فلكتيس - ش		      |	: ىلي امب ةتقوملا ةيذمفنتلا ةطلسللا فلكتيس -- ش
وا مهسفنا ةـنجللا وفظوم اهب ماق يتلا ةروشنملا تاساردلاو ثوحبل |	وأ مهسفنا ةنحللا وفظوم اهب ماق ىتلا ةروشنملا تاساردلاو ثوحبلا
. ايروس يف ةذفانلا					      |	. انروس ىف ةدفانلا
ةخسن اهنأ ىلع ةطوطخملا كلت نم هباتك يف اهجردأ يتلا جذامنلا لد |	ةخسن اهنأ ىلع ةطوطخملا كلت نم هباتك يف اهجردأ ىتلا جذامنلا لد
ساـنلل مجارت ىلع يوتحي رخآ مسق يرمعلا باتك نم يفارغجلا مسقلا  |	سانال مجارت ىلع يوتحي رخا مسق يرمعلا باتك نم يفارغجلا مسقلا ى
١١/١ ةنايسبجالا دمحا ما					      |	(١/١  ةنايسبيجالا 03--- دمحا م
ًالدعا ًاقحمً افيرتص اهفرصي نا نيفظوملا ناويد عـيطتسي يتلا قوقحل |	الداع أقعم ًافيرصت اهفرصي نا نيفظوملا ناويد عيطتسي يتلا قوقللا
ًاينف اًليلمع اًلكش ةساردلا ذختت ةقيرطلا هذهبف . ةيسردم ةرشن راد |	ًاينف اليلمع الكش ةساردلا ذخيتت ةقيرطلا هذببف . ةيسردم ةرشن را
هردص حتف يقيدص نا وه هلجال ىلوملا تركشو ًاريثك ينع ففخ يذلا نك |	هردص ميتف يقيدص نأ وه هلجال ىلوملا تركشو ًاريثك ىنع ففخ يذلا ن
ًابئان يلكشيشلا بيدا ديقعلا ةيمستب رخآ موسرم ردصو ءارزولا سلجم |	ايئان ىلكشيشلا بيدا ديقعلا ةيمستب رختآ موسرم ردصو ءارزولا سلج
. دالبلا ءاحنا فلتخم يف ىرخا ةينارمع			      |	. دالبلا ءاثأ فلتع يف ىرخا ةنارمح
. يفاقتلا صلجملا - ج . يداصتقالا سلجملا - ب . عافدلا سلجم - ا |	. يفاقتلا صاخملا-ج . يمداصتقالا سلجحملا -ب  . عافدلا سلي ا
. يرطيبلا						      |	. ىرطسلا
الو . ىحصفلا زيكرتل ةدينع ةلواحم عم ةيبعشلا مهافتلا تاجهل     |	الو . ىحصفلا زيك رتل ةدينع ةلواحم معم ةيسعشلا مهافتلا تاحم
. مويلا اذه خيراتب دوقعملا ةيفصتلا قافتا يف لخدي مل يذلا ءزجل |	. مويلا-اذه خيراتي دوقعملا ةيفصتلا قافتا يىف لخدي مل يذلا ءزخ
. ةديدجلا ثادحالا هاجت لئاسولا دادعال ةصرف ةموكحلا طعي مل ريص |	. ةديدهلا ثادحالا هاحن لئاسولا دادعال ةصرف ةموكتلا طعي ملديصت
يتلا ةيرادإلا ةئيبلاب متهت نأ بجي ةيرادإلا ةفرعملاف . يرادإلا |	ىتلا ةيرادإلا ةئيبلاب متبع نأ بجي ةيرادإلا ةفرعملاف . يرادإلا
ةيمألا ةحفاكم ةلمح					      |	ةممألا ةحفاكم ةلمح
ةعقر عاستا نم مغرلاب ذا .ً اضاي قارعلا قطانم ضعب ىلع هسفن ءيشل |	ةعقر عاستا نم مغرلاب ذا . أضيا قارعلا قطانم ضعب ىلع هسفن ءىشل
سرادم لعج يذلا ببسلاو . سرادملا هذه ةرايزل رطق لك نم نودفاوتي |	سرادم لعج يذلا ببسلاو . سرادملا هذه ةرايزا رطق لك نم نودفاوتي
لاحرل رفغا مهللا - ١					      |	لاحرل رفعا مهللا -١
. يركسعلا يكريمالا لخدتلل ةجيتن نانبل يف نييلودلا نيبقارملا ل |	. يركيسلا ىرمالا لخدتا ةجيتن ثانيل يف نييلودلا نيبقارملا لامت
يف زيزعلا دبع ورتايتب هحرسم ىلع ةمجرتلا هذهب ةيحرسملا هذه لثم |	يف زيزعلا دبع ورتايتب هحرسم ىلع ةمجرتلا هذبب ةيحرسملا هذه لثم
اـصرفلا هنم راهزاللا بهنت				      |	ابصرفلا هنم . راهزإلا ببثتت
برحلا تائيس مهلمحت دعب مالسلا تاريخ ىلا نونحي اوذخا نيذلا ىرخ |	نرللا تائيس مهاسحن دعب مالسلا تاريخىلانونجي اوذخا نيذلا ىرخال
نيينادوسلل اهلالخ ةدايسلا				      |	نينادوسال اهالخ ةداسلا
نررالا تناكو . ةيليئارسالا يضارالا ىلا نيراحسلا ةليبق نم لحرل |	نررالا تناكو . ةيليئارسالا يضارالا ىلا نيراحسلا ةلبق نه لحرلا
. ررضلا هقحل يذلا صخشلل ةبه اهمدقت ةفلاتلا ةعاضبلا وا ةقراغلا |	,ررضلا هقُح يذلا صخشلل ةبه اهمدقت ةفلاتلا ةعاضبلا وا ةقرافلا ة
ةدحتملا ةيبرعلا ةيروهمجلا ةموكح ىلا تبلط اهنا ةيقارعلا ةيجراخ |	ةدجتما ,ةيب رعلا ةيروبمحا ةموكح ىلا تيلط امنأ ةيقارعلا ةيحراخ
ةيكاطنا ىلا ةجنرف كلم نم مهعم ام عيمجو ةدوعلاو كسملا نوعيبيف  |	ةيكاطنا ىلا ةثرف كلم نم مبعم اه عيمجو ةدوعلاو كسملا نوعيبيف ا
ضعبو ييايفوسلا داحتالا ماق ةريخالا نينسلا يف هنا ملعلا عم اذه |	ضعبو يتايفوسلا داحتالا ماق ةريخالا نينسلا يف هنأ ملعلا عم اذه
مهلمع يف مهدعاسي خويش ديب مومعلا هجوب ةيفيرلا قطانملا ةرادا ت |	مهلع يف مثدعاسي خومش ديب مو.علا هجوب ةيفيرلا قطانملا ةرادا تن
. ةيليئارسالا دودحلا نم نيبيرقلا ةيوازلاو ةرطينقلا يئاضق ادع  |	. ةيليئارسالا دودخلا نم نيسرقلا ةوازلاو ةرطبنقلا يناضق ادع
راثآلاو نامثلا تاقبطلاب ةينبالا فصو عقوملا اذه رايتخا ىلا تدح |	راثالاو ناملا تاقمطلاب ةينبالا فصو عقوملا اذه رايتخا ىلا تدح 
عيضاوم تناكف ىربكلا ةيبرعلا ةرادإلا تالكشم سردب تس ناجل ىلا د |	عيضأ وم: تناكف ىريكلا ةيبرعلا ةرادإلا تالكشم سردب'تس ناجل ىلا
: ةرامحلا نبا نيحلت نم روهشملا رعشلاو			      |	: ةرامحا نبا نيحلت نم رووشملا رعشلاو
يذلا لجرلا ةقيقح ىلإ لوصولا يف حجني نأ اهتطساوب كلملل نكمي ةد |	ىذلا لجرلا ةقيقح ىلإ لوصولا ىف حجني نأ اهتطساوب كلملل نكمي ةد
نمم مهريغ [الو ....] نبا الو يدوج نبا الو ةرامحلا نبا الو ةجا |	نمم مهريغ | الو.... | نباالو يدوج نباالو ةرامحلا نباالو ةجاب 
ملعا هللاو نيعلا [ىأر] ىر [هتدهاش] هتهاش ام اذهو ىناديملا دي  |	ملعا هللاو نيعلا ] ىأر [ ىر | هتدهاش [ هتهاش ام اذهو ىنادمملا
. ةيبنجا						      |	. ةيسنجأا
ةسايسلاب وا خيراتلاب وه امو داصتقالاو ةسايسلاو خيراتلاو ملعلا |	ةسايسلاب وا خيراتلاب وه امو داصتقالاو ةسايسلاو خيراتلاو .ملعل
. امهنيب						      |	+ امهنيب
ةنيدم يهو ةينيطرب ةنيدم ىلا يهتنت يتح رهشا ةعبرا ريستف جرخت ا |	ةنيدم يهو ةشطرب ةنيدم ىلا يبثنت ىح ربشا ةعبرا ريستف جرخت اهلم
نودوعي اهتراحبو تيوكلا راجتف . جراخلا يف ةمئادلا هتماقا مهدحا |	تودوعي امراحمو تيوكلا رادتف .جراخلا يف ةئادلا هتماقا هدحا ذْخَت
نع برعلا اهثرو دـيلاقتو تاداعب زيمتت اذه بناج ىلا ةيبرعلا ةاي |	نع برعلا اهثرو دللاقتو تاداعي زيمثت. !ذه سناج ىلا ةيبرعلا ةاي
ريرحتلا سيئر						      |	ربرحتلا سيئر
ةوهش ايندلا نم يطعا نم لكو . هتبغر ةرخآلا نع تلق همه ايندلا ت |	ةوبسامندلا نم ىطعا نم لكو . هتيغر ةرخآلا نع تلق همه انندلا تن
خارفلاو كمسلاو يلقابلاك اهريخبت رثكي يتلاو نارفعزلاو ةعيملاو  |	خارفلاو كتمسلاو ىلقابلاك اهريخبت رشلكتي يلاو نارفعزلاو ةعئيمل
يبويألا يرحبلا لوطسألا					      |	يبويآلا يرحبلا لوطسألا
اهنكمي ال ةيقالخا ةيبقانم ةيرظن ساسالا يف يه ثيح نم اهناو . ي |	ابكتم ال ةيقالخا ةيبقاغم ةيرظل سابسالا يف يف ثيح نف اهناف . ي
. ةماع ةفاقث ىلا بعشلا ةجاح ءامعزلا مهفت ىلع فقوتت	      |	. ةماع ةفاقث ىلاسعشلاةحاح ءامعزلا مهفت ىلع فقوتت
تناك ةعانصلا نا يا لماك لكشب مهريغ نع تاعانصلا اوذخا يسابعلا  |	تناك ةعانصلا نا يا لماك لكحثب مريغ نع تاعانصلا اوذخا يمايعلا 
دادعالل يقيرفالا زكرملا : لاثملا ليبس ىلع اهنم ركذن اهتامهمب  |	دادعالل يقيرفالا زك رملا : لاثملا ليمس ىلع اهنم رك ذن اهتاهمب
ةينطولا حلاصملا قيقحت ىلع ممصملا لمعلا يه اـهتمهمف . ةيبيرجتل |	ةينطولا حلاصملا قيقحت ىلع. ممصملا لمعلا يه اهتمههش . ةيبيرحتل
. هدج يف نيضوفملا مهئارزوو ةيبنجالا لودلا لصانق نم مهرصاع نمم |	. هدح يف نيضوفملا مهغارزوو ةيبنحالا لودلا لصانق نم ممرصاع نمم
نييفحصلا ىلا نوعمتجي نيلوؤسملا لاـجرلا ةيبنجالا نادلبلاو ةيبر |	نيفحصلا ىلا توعمتمي نيللوؤسملا لاجرلا ةسنحالا _'رادلبلاو ةيبر
الو . ءانغلاو صقرلا اهللختي ةجهبم ةحرم ةرتف ءاضقل نوتأي ةرواج |	الو . ءانغلاو صقرلا اهالختي ةجهمم ةحرم ةرتف ءاضقل نوتأي ةرواو
ريرحتلا ةنجل						      |	ريرص ني
نا نكمي لاملا سأر يف ريفوت نم كلذ عبتي ام نا . ةريغصلا ةيجاتن |	نا نكمي لاملا سار يف ريفوت نم كلذ عبتي ام نأ . ةريغصلا ةيجاتن
مه طسوالا قرشلا يف تاموكحلا يفظومو لامعالا باحصا نا فورعملا   |	مه طسوالا قرشلا يف تاموكحملا يفظومو لامعالا باحصا نأ فورحملا
. ةيلاملا اهئابعاب مايقلا نم اهنيكمتل ةلاكولا قودنصل عربتلا ى |	. ةيلاملا امابعاب مايقلا نم اهننكدلل ةلكولا ىودنصل عربتلا ىلع
ةنيدملا ةالو						      |	ةديدملا ةالو
لوعفم ءاـهتنا نع ءىشانلا عـضولا يف اورظنو نيدلبلا مهت يتلا رو |	لوعفم ءابتنا نع ءىثانلا عضولا يف اورظنو نيدلبلا مهت يتلا روما
. يكريمالا لخدتلا بجشي ناريسع لداع ديسلا ينانبللا يباينلا سلج |	. ىريمالا لخدتلا بحشي ثاريسع لداع ديسلا ينانمالا ينانلا ساجنا
. مامتهالا قحتسي نيئجاللا لجال				      |	. ماجهالا قحتسي نيئحاللا لحال
امذ الا يتجهم يف عدي مل					      |	امذ الا ىتحبع يف عدب مل
. لوهجم ليصحت ىلإ يدؤي هجو ىلع تامولعملا بيترت ةيفيك نع ثحاب  |	.لوهجم ليصحت ىلإ يدؤي هجو ىلع تامولعملا بيترت ةيفيك نع ثحاب م
ةيقافتالا بجومب ةيقارعلا ةموكحلا ىضاقتتسو . قافتا ىلا قارعلا  |	ةنقافتالا بجو# ةيقارلا ةموكسللا ىضاقتتسو . قافتا ىلا قارعلا ي
ةقيقح نيخرؤملا اوربخي ىتح ىزغملا نوملعي اونوكي مل ةبصنالا هذه |	هةقيقح نيخروملا ادربخي قح ىزغملا نوملعي اونوكي مل ةبصنالا هذه
يناه نبا						      |	 يناه نبا
ناب داقتعالا ىلا ليمن اننا ريغ . حضاو دحاو ىنعم ىلا اهدر ثحاب |	ناب داقتعالا يلا ليم اننا ريغ .حضاو دحاو "ىنعم ىلا اهّدر ثحابل
- - - - - - - -						      |	هد س س شد ك ساسا -أ
. رهقلا ىلع ءاوتسالا					      |	.رهقلا ىلع ءاوتسالا
ةماعلا ةرادالا بيلاساو دعاوق				      |	ةماعلا ةرادالا بيلأساو دعاوق
نم ةريبك ةجرد ققحت ةيداصتقالا طباورلا ناو ايداصتقا رخالا امهن |	نم ةريبك ةجحرد ققحت ةيداصتقالا طباورلا ناو ايداصتقا رخالا اهن
ريفوتلاو داصتقالاو هيف ةدوجوملا تالوكأملا ةحصو ةفاظن ىلع ةظفا |	ريفوتلاو داصتقالاو هبف ةدوجوملا تالوك أملا ةحصو ةفاظن ىلع ةظف
ةليمجلا نونفلا						      |	ةليمحلا نودعلا
فرصملا يف ةيدقنلا اهلاوما نم ءزج عادياب اهمازلاوً اقبسا انرشا  |	فرصملا يف ةيدقنلا اهاوما نم ءزج عادياب اههازلاو أاقباس انرشا 
. ةعساو ًاـقافآ انماما حتفي عونلا اذه نم ًايرابتخا اًلمع نا . ةب |	. ةعساو ًاَقاف آ انماما متفي عونلا اذه نم ًايرايتخا المع نا . ةي
ارارم حرص دق رطاخ روتكدلا نا اصوصخ ةبقاع ملسا وه يفرحلا لقنلا |	ارارم حرص دق رطاخ روتك دلا نا اصوصخ ةيقاع لسا وه يفرحلا لقنلا
سلدنالا يف يبدالا دقنلا خيرات يف ةيانعلا قحتسي دحاو رهظم كلذ  |	سلدنالا يف يبدالا دقنلا خيرات يف ةيانعلا قحتسي دحاو ربظم كلذ 
لامعالاب مايقلاو ةرادالا ماهم ذخال نييلحملا ناكسلا بيردت ىلا  |	لامجالابمايقلاو ةرادالا ماهم ذخال نييلملا ناكسلا بيردت ىلا نو
ةعانصلا جاتنا لوح ةيئاصحالا تامولعملا رشنو ليلحتو عمجل دادعتل |	ةءانصلا ماتنا لوح ةيئاصحالا تامولعملا ريشنو ليلحتو عمجب دادعت
اياضق يف كلذ نم يهتني ام اريثكو ظافلالاب فرصتلا نسحي يذلا نان |	اياضق ىف كلذد نم ىبتني ام اريثك و ظافلالاب فرصتلا نسحب ىذلا ن
لـبقلا تاـيهشم يناوحقألا اـهرغث اياـنث مـساـبملا رـمح	      |	لبقلا 2 تايهشُم  يناوحقألا اهرغث ايانثث ٌممابملل رمح
ةكرتشملا حلاصملل ىلعالا سلجملا ىلا اهميلست ةسنرف ىلع بجاولا م |	ةرتشملا ملاصملل ىلعالا سلجملا يىلا اهميلست ةسنرف ىلع بجاولا م
ةلماح ردصت ةيداعلا ةنمزالا يف دئارجلا لعجي ام اذهو نوصتخملا ا |	ةلماح ردصت ةيداعلا ةئمزالا ىف دنارطا لعجيام اذهو نوصتٌغا اهورر
ثاحبالا هذه لعج يف اهعم نواعتلل صاصتخالاو ركفلا لاجر وعدت يهو |	ثاحنالاهذه لعج ىف ابعم ثواعتلل صاصتخالاو ركفلا لاحر وعدت يهو
.ً اضاي باتكلل						      |	. أضنا باتكلل
سيلو . اهيأرب ديقتي الو ةلودلا نوؤش يف اهيلا عجري ةنيعم ةئيهب |	سيلو . اهيأرب ديقتي الو ةلودلا نوؤش يف اهيلا عجرب ةنيعم ةئمبب
ىلع داقعلا دمحم روهمجلا برطيو				      |	ىللع داقعلا دمحم روهمجلا برطيو
. ةيرحلاو لالقتسالا لظ يف ةسدقملا ةينمالا هذه قيقحت	      |	. ةيرعاو لالقتسالا لظ يف ةسدقملا ةمنمالا هذه قيقحت
كلذكو . مويلا اـهريغ يه اماع نيسمخ ذنم ةينانبللا ةيماعلاف     |	كلذك و . موملا اهريغ يه اماع نيسمخ ذنم ةينانبللا ةيماعلاف
روصلاو موسرلاو طئارخلاب دوزمو بهسمو عئار ريرقتلاو . اهملاعم ر |	روصلاو موسرلاو طئارخلاب دوزمو ببسمو عئار ريرقتلاو . اهمللاعم 
. هيلع تلصح يذلا لعفلا در				      |	. ةيلع تاصح ىدلا لعفلا در
ةحلسالاب ةصاخلا ةيلاملا لئاسملا ضعب ثحبو تاعوفدملا ميظنت نأشب |	ةحاسالاب ةصاخلا ةيلاملا لئاسملا ضعب ثحبو تاعوفدملا مظنت تأشب 
ناتنثا اهنم ابيرقت نوعبرا ةكلمملا ىف ةثيدحلا ةيئادتبالا سرادم |	ناتنثا ابنم امدرقت نوعيرا ةكلمملا .ىف ةثيدخا ةيثادترالا سرادم
يهو يمورلا قيرطبلا اهيلا راشا يتلا ةثالثلا بويعلا نع نيبتاكلا |	ىهو يمورلا قيرطبلا اهيلا راشا ىتلا ةثالثلا بومعلا نع نيبتاكلا
اـهنا ذا ةيح كش الو اـهنا حرصف يدنالوهلا كوهنوفيل وه قئالخلا  |	اهنا ذا ةيح كُس الو اهنا حارصف يدنالوهلا كومنوفبل وه قئالخلا ن
رخآ دلب ىلا ةعلسلا كلت عنص لقن ام اذاف . ريخلا يف ةدايزف ًانكم |	رخخآ دلب ىلا ةعلسلا كلت عنض لقث ام اذاف . ريخلا يف ةدايزف ًانك
لمعلل تاعامتجا اهنا ساسا ىلع ةمظتنم ةروصب هذهك تاعامتجا ينبت  |	لمعلل تاعاّتحا امبا ساسا ىلع ةمظنتنم ةروصب هذهك تاءاّتجا ىنبت د
يتلا لبانقلاف . ةيزاـنلاو ةيتسشافلا نايغط دض يملاعلا عارصلا ى |	ىتلا لبانقلاف . ةيزانلاو ةيتسشافلا .نايغط دض ىملاعلا عارصلا ى
يبويالا نيدلا حالص					      |	ينويالا نيدلا حالص
نم ةيلامشلا قطانملا تناك رشع عباسلا نرقلا ةياـهن يفو . دالبلا |	نم ةيلامشلا قطانملا تناك رسشع عباسلا ىررقلا ةياسن يفو . دالمل
مهعئاقوب ًاينغتم ناشلا يوذ ىلا ًافلزتم يريمالا وهبلا وا يكلملا  |	مهعت اقوب اشغتم ناشلا يوذ ىلا ًافلزتم يريمالا وهبلا وا يكتاملا
وا . اهتدابا ةيفيكو اهتشيعم قرطو تاعورزملاب ةرضملا تارشحلا سر |	وا . اتدابا ةيفبككو اهتشدعم قرطو تاعورزملاب ةرضملا تارشحللا س
ممالا ةبصع سلجم يف ةيوضعلا تناكف . ةدحتملا ممالا ةئيه اهدعب ن |	ممالا ةيصع سلح يف ةيوذعلا تناكف . ةدحتملا ممالا ةئيه اهدعي نم
. زايتمالا بحاص ىلا اهحابرا مظعم دوعيو سيراب يف اهلك فظوت تاك |	.زايتمالا بحاصملا اهحابرا مظعم دوعيو سيرابيف اهلك فظوتتاكن رف
نييرضحلا ناكسلا ةبسن					      |	ناي رضخلا ناكسلا ةبسن
زاجحلا ةرادإ						      |	زاسكا ةرادإ
مهريغ دـحال قحي الو . تاوصالا زرفو تيوصتلا تايلمع بقاريو رضحي |	متريغ دحأل قحي الو . تاوصألا زرفو تيوصتلا تايلمت فقازيو رضح ن
نيلثمم دوجو ىلع يوطني مسالا نال انه مسالا اذه اهيلع قلطا نل ي |	نيلثم ةوحو ىلع يوطني مسالا نآل انه مسالا اذه اهيلع قلطا نأ ىن
. يبرعلا قرشلا خيرات تلمش يتلا ةمجرتلاو فيلأتلا ةكرح طشنت نا  |	.يبرعلاق رششلا خيرات تاىش ىتلا ةحرتلاو فيلأتلا ةكرح طشنت نا ي
. يدرفلا دوهجملا عيجشت ىلا دالبلا ةجاح عم ضراعتي ام دوعولاو   |	. يدرفلا دوبجما عيجشت ىلا دالبلا ةحاح عم ضراعتي ام دوعولاو
. سميج . ربرث						      |	* سممح . رسضارت
لكشلا باـصا ديدجتلا اذه نا ملعن نحنو . ديدجتلا نم داقنلا فقوم |	لكشلا باصا ديدجتلا اذه نأ ىلعن ن>يو . ديدجتلا نم داقنلا فقوم 
وهو . دالبلا يف اهنوضقي يتلا ةدملا ةدايزو بناجالا نيحئاسلا دد |	وهو . دالبلا يف ابنوضقي يتلا ةدملا ةدايزو بناحالا نيحغغاسلا د
ضعب يوريو يناثلاو لوالا يسلا ىلا يهتنيف هترابع ةسالسو باذجلا  |	ضعب يوريو يناثلاو لوالا يبسلا ىلا ىهتنف هتوابع ةسالسو باذملا 
ىلا ايناطيرب نم رفسلل الثم ةماعلا ةحصلا وا بلقلا ةحارج يف نيي |	ىلا اناطيرب نم رفسلل الّثم ةماعلا ةحصلا وا بلقلا ةحارح ى نيصاص
زاهجلا نع هريرقت يف دراولا ركنس لوب ريسلا يأرً اضاي وه اذهو .  |	زابملا نع هربرقت ىف دراولا ركنس لوي ريسلا يأر أضيا وه اذهو . 
مالا ةبرلا وا تيدورفا مسا اوسانت نكلو تيزلاب هتراجح نوحسميو م |	مالا ةيرلا وأ تيدورفا ممأ اوسانت نكلو تيزلاب هتراحح نوحسعو مي
. ةنامورلا ةريظحلا ىلا ةلتحملا				      |	. ةمنامورلا ةريظحلا ىلا هتحلا
. وفعلا حارتقا لبق ةفرتقملا مئارجلا نع ماعلا		      |	. وذعلا حارتقا لبق ةفرتقملا مثارطا نع ماعلا
دبع بيج لسرا ظفل يفو ىرداوقلا قاذرلا دـبع ديسلا ىلا بسلاو متش |	دينع بيح لسرا ظفل يىفو ىرداوقلا قادرلا لبع ديسلا ىلا بسلاو مش
ىلع ثحبلا كلذ يف امب ةكرتشم ةعفنم تاذ نوكت ةمئاقلا لكاشملا ضع |	ىلع ثحبلا كلذ يف ام ةك رتشم ةعفنم تاذ توكقت ةمئاقلا لك ادْلا ض
. ةرافس ةجرد ىلا نيدلبلا نيب يسامولبدلا ليثمتلا عفر ررقت دقو  |	. ةرافس ةحرد ىلا نيدلبلا نيب يسامولبدلا ليثمتلا مفر ررقت دقو
. اهاوه عبتي						      |	, اهاوه عش
ناجشا . ليصالا حابشا . ةريهظلا جهو . حابصلا ةظقي : نم سبتقم . |	نراخشا . ليصالا حاشا . ةريبظلا جهو . حابصلا ةظقي : نم ستقم , 
نم صوصنلاو بتكلا هذهل امل ثحبلا اذهل ددحملا رصعلا لالخ ترشن ي |	نمصوصنلاو بتكلا هذهل ال ثحبلا اذهل ددغغا رصعلا لالخ ترشن ىتلا
بعشتم صصختم زاـهج ةطخلا هذه جمارب ذـيفنت ىلع فارشالا .	      |	بعشتم صصختم زاهج ةطخلا هذه جمارب ذيفنت ىلع فارشالا 
: بساحلا نبا نيحلت نم وهو يسنلبلا قاقزلا نبا رعشو	      |	: بساحلا نبا نيحلت نم وهو ىسنلسلا ىاقزلا نبا رعشو
نع هـتمتاخو هايملاو ةعارزلا نع لصف هيفو . هلودلل ةيبنجالاو ةي |	نع هنتاخو هاملاو ةعارزلا نع لصف هيفو . هلودلل ةسنحالاو ةيبرعل
يحاونلاب نومتهي لئالق نيربخم ىلع دمتعت ةيبرعلا دئارجلا امنيب  |	يحاونلاب _هو.تم لئالق نيربخم ىلع دمتعت ةيبرعلا دئا رلا انيب ر
ةمظنالاو نيناوقللً اقوف اهلبق نم اهلامعتسا نكميو ةلماكلا ةيسنر |	ةءظنالاو نيناوقلل ًاقفو املدق نم اهلاعتسا نكميو ةماكلا ةسنرفلا
ةيلخلا ةدحو بهذم قاثبنا دهاش يذلا ًابيرقت ليجلا سفن يف سوردلا  |	ةءاحلا ةدحو بهذم قاثننا دهاش يذلا ًاسرقت لملا سفن يف سوردلا هذ
الا مهللا - رخآ بعش اهيلا مهقبس املق ةجرد ىلا لصو يذلا نوناقل |	الا مهللا - رخآ بعش اهيلا مهقبس اماق ةجرد ىلا لصو يذلا نوناقل
ودبيو . ًايعوضومً اخرمؤ الً اعفامد ًارشبم ةيميت نبا نع هتباتك يف  |	ودسو . ًاعوضوم أخرؤم ال ًاعفادم ً]رشيم ةيميت نبا نع هتباتك ىف نا
تاضواـفملا يف لوخدلا نم ريغلا عنمي ال هسفن ةصاخ يف ةطخلا هذهب |	تاضوافملا يف لوخدلا نم ريغلا منمي ال هسفن ةصاخ يف ةطخلا هذبب 
ةماقاب حمس دق ةدحتملا ممالا ةمظنم يفً اوعض ةيدوعسلا ةيبرعلا ةك |	ةماقاب مممس دق ةدحتملا ممالا ةمظنم يف ًاوضع ةيدوعسلا ةيبرعلا ة
ةيبرعلا لودلاو نانويلا يف تمقافت نا تثبل ام نيدرـشملا نيئجالل |	ةسرعلا لودلاو نائوملا ىف تقافد نا ثّثل ام نيدرسثملا نيثحاللا ة
ةيناملرب تاراشتساب ةيروهمجلا سيئر موقي نأب ينانبللا يسايسلا ف |	ةيناملرب تأراشتساب ةيروهمجا سيئر موقي نأب يناتيللا يساسلا فرع
باتكلا راد						      |	كاشخا5
ةقيرطلاف . مدآ ءانبأك ةريثك هللا ىلا قرط ةيفوصلا لوقي امك كان |	ةقيرطلاف .مدآ ءانبأك ةريثك هللا ىلا قرط ةمفوصلا لوقي اك كانبف
ةركف تناك . ةررحملا ةيبرتلا هنمضتت نا بجي ام يف نيعم دحل ولو  |	ةركف تناك .ةررحغأ ةيبرتلا هنمضتت نا بحي ام ىف نيعم دخ ولو راث
أدبت هرفطلا نانظيو . تانيجلا رغصل هتيؤر نكمي ال تانيجلا ةعيبط |	أدت هرفطلا نا نظيو . تانيطا رّهصا هتيؤر نكمي ال تانيملا ةءيط ي
: ةيسايسلاو ةيعامتجالا فورظلا ببسب ةعئاضلا ةيرشبلا دراوملا :ً  |	: ةمسامسلاو ةيعاتحالا فورظلا بيس ةعئاضلا ةيرشلا دراوملا : ًاعب
. قارعلا كلم ينانلا لصيف كلملا				      |	٠. فقارعلا كلم ىبالأ لصيف كلملا
. يرئازجلا يعويشلا بزحلا لحب الليب نب دمحا يرئازجلا سيئرلا رم |	. يرئازجلا يعويشلا بزكلا لحب اللس نب دمحا يرئازجلا سيئرلا رمأ
. تاليهستلاو ينابملا متت املاح				      |	. تاليبستلاو يفابملا متت املا-
. ةيعقاو فادهألا نوكت نأ يغبني -			      |	.ةيعقاو فادهألا نوكت نأ يغبني -
روحالا لازغلاك ينانج يروح رمسالا بيضقلاك ىنثت رمسأ	      |	روحالا لازغلاك ىينانج ىروح  ٌرمسالا َبيضقلاك ىنثت رمسأ
رايتخالا قح اهبجومب حنم يتلا ىرخالا تاطلسلا عـيمجل هتسرامم دن |	رايتخالا قح اهبحومم حنم يلا ىرخالا تاطلسلا عبمب هتسرام دنع هر
نا ينانبللا يعانصلا دادعتلا نع ريراقتلا أرقي نمل رهظيو . ةيعا |	كرأ يناتيللا ىعانصلا دادعتلا نع. ريراقتلا أرقب نأ ربظبو . ةيع
يسآم نم ةيناث ةاسأم ىلع راتسلا لدسا ةنسلا كلت يف - انخيرات يف |	ىمام نم ةيناث ةاسأم ىلع راتسلا لدسا ةئسلا كلت ىف - انخراتىف ة
هل عضخي ًاـتباثً امانظ ملاعلا يف ناب يعيبطلا نوناقلاب نونمؤملا  |	( عض# ]تباث ًاماظن ملاعلا يف ناب يعببطلا نوناقلاب نوئمؤملا لاق
ثاحبألا							      |	تاحلا
تاداقتنا دض هدعاسو هججحو يبلكلا نبا ءارآ نم ربكالا مسقلا تبثأ |	تاداقتنا دض هدعاسو هججحو ىلكلا نبا ءارا نم ربكالا مسقلا تبثآ 
توريب يف ةيكريمألا ةعماجلا اـهردصت ةلجم			      |	توّربإ لكدمألا فماجبا ايحررصنرب
. اذه ضيقن ىلع رمالا لب فلحلا وا			      |	. اذه ضميقن ىلع رمالا لب فللا وا
. بيجن دمحم ماعلا دئاقلاو يكريمالا ريفسلاو اشاب رهام يلع سيئر |	. بيجن دمس ماعلا دئاقلاو جريمالا ريفسلاو اًساب رهام ىلع سيئرلا
ىأر نم لواو . رطفلا روذبو ةريمخلا ايالخ اوأرو ةملاسملاو ةراضل |	ىأر نم لوأو . رطفلا روذبو ةريجلا ابالخ اوأرو ةملاسملاو ةراضلا
: ةيلاتلا ماكحالا نم ودبي امك ةيمكلا ثيح نم فيلستلا ديدحت :ً ا |	: ةيلاثلا ماكحالا نم ودبي م ةيمكلا ثيح نم فيلستلا ديدحت : آلو
. نيعم يـنس ميعزو ةيروهمجلا سيئر نيب أشنت يتلا ةديطولا تاقالع |	. نّمعم يّنس معزو ةيروهما سيئر نيب أشنت يتلا ةديطولا تاقالعلا د
ةسايسلل مت اذا هناف اذهلو . ةراسخب انايحا اهعيبو جراخلا ىلا م |	ةسايسل[ مث اذا هناف اذهو .ةراسخانامحا اهعيبو جراخلاىلا مهعئاض
عمتجملا لجا نم لمعلا ىلع ءاضعالا بردتف اهلامعا ذيفنت يف ةيبزح |	عيشلا لجا نم لمعلا ىلع ءاضعالا بردتف اهلاءءا ديفنت يف ةييرالا
يبرـعلايملـعلا ركـفلا روطت				      |	لرسلايلايلار وطت
. دالبلا						      |	, هالأا
. نامع يف يناطيربلا لخدتلا دض ةدحتملا ممالا ىلا ًاجاجتحا ةيقير |	. نا.ء يف يناطي ريلا لخدتلا دض ةدحاملا مهالا ىلا ًاحاحتحا ةيقي
ءابنالا تالاكو تماقو . ةلوهسب هعفدت نا ةديرجلا عسوب ًالوقعم ًاك |	ءابنالا تالكو تماقو .ةلوهسب هعفدت نا ةديرجلا عسوب ًالوقعم أك ا
. لخدلا ىوتسم طوبه متحتيف فيظوتلاو			      |	. لخدلا .ىوتسم طوبه ممحتبف فيظوتلاو
نويع ناهرلا موي اهب تقلع اـهنا ال اـهقبس ةعاسب تفرع	      |	اكوبع تاهرلا::موي اب تقلع ابهنا ال اهقبس ةعاسن ٍتفرع
تضق ثيحب ينامورلا مالسلا بابشلا دهع يف ةيريشبتلا برحلا تطشن د |	تضق ثدحيلام ورلا مالسلا باشلا دهعيف ةيريشدتلا ب رخا تطشن دقف.
لب ًاـعبارم سيل هناف لوصحملا نم هتصخ ذـخأي ناك ناو عرازملا نا  |	لب ًاعبارم سل هناف لوصحملا نم هتصخ ذخأب ناك ناو عرازملا نا ا .
. عمتجملا ةحلصم عم وا نيرخآلا قوقح عم ضراعتت ال تماد ام اهدكؤ |	. عمتجملا ةحلصم عم وأ نيرخآلا قوقح عم ضراعتت ال تماد ام اهدئو
يفو ريصملا ريرقت يف نيينادوسلا قحبً اديوط ًاناميا ةيرصملا ةموكح |	ىفوريصملا ريرقت ىف ثيينادوسلا قحي ًاديطو ًاناعا ةيرصملا ةموكتمل
هبولساو . حالصالا لجا نم ةقداص ةينطو ةبغرب هتجلاعم يف عوفدم ف |	ةيولساو . حالصالا لجأ نم ةقداص ةينطو ةيغرب هتحلاعم يف عوفدم ف
لاملا مئارج وا لجرلا نيا				      |	لاملا تارج وأ لجرلا نا
نانبل - توريب						      |	نانتل - توزريَب 
نم لئاسلا ركسلل لمعمو ةيعارز تاعانصو ديدحلل رخآو قرولا لمعمو  |	عرم لئاسلا ركسسلل لمعمو ةععارز تاعانضو ديدحال رخنآو قرولا لمع
لمحتتل ةيعيرشتلا سلاجملا هذه ةيوقت مويلا ةيطارقميدلا تابجاو م |	لئختتل ةيعيرشتلا سلاجملا هذه ةنوقت مويلا ةيطارقيدلا تابجاو مه
ةدحتملا ممالا اهب تصوا يتلا فيراعتلا عم قفتت لوالا ريرقتلل ةم |	ةدحتملا مهالا اب,تصوأ ىبلا فيراعتلا عم قفتت لوالا ريرقتلل ةمد
تاريخلا هذه ىلع اولصحيل مهعسو يف اـم لك اولمعي نا مهبولق يف ا |	تاريكلا .هذه ىلع اواصخبل مرعسو يف ام لك اواءعي نا مهبولق يف ا
وا ةلادعلا ققحيل نكي مل ماظنك وهو . سسالا هذه هل اـملاط كلذ س |	وأ ةلادعلا ققحيل نكي مل ماظنك وهو . سسالا هذه هلا_ ح لاط كلذ 
ررحم يتيام نم برقي ام ةيكريمالا دئارجلا ضعب ريرحت مسق يف تدها |	ررحم يتبام نم برقي ام ةيك ريمالا دئارطا ضعب ريرحت مسق يىف تده
. تانب ثالثو						      |	. تانش ثالثو
ةربخلا لها مامتها ريثي نأب ريدج نابانكلا اهاوتحا يتلا ةداملا  |	ةريللا لها ماتها ريث تأب ردح تاباتكلا اهاوتحا لا ةدالا نم.ريك
ةيميظنتلا ةطلسلا					      |	ةمظتتلا ةطلسلا
اـمبر وا انب بهشلا تراغ					      |	امير ىا انب ببشلا .تراغ
ًاحاحلإ دشا ليماسرلا ىلا ةجاحلا تحبصا نيئجاللا ليس قفدتبو . اه |	احالإ دسا ليماسرلاىلا ةجاطلا تحصا نيثحاللا لهسؤةدتيو .اهناكتس
ريبكلا جاتنالا نمضتي ينفلا ءامنالا نا ريغ . ةدحتملا تايالولاو |	ريبكلا جاتنالا نمضتي ينفلا ءانالا نأ ريغ.ةدحتملا تالايولاو اب
